original	analyzed	corrected
Santaṃ santaṃ sadā vaṭṭaṃ, pajaṃ’bhave sutaṃ;	santam santam sadā vaṭṭam sutam 	santam santam sadā vaṭṭam pajam bhave sutam
Tasmā dittaṃ mame’dāni, jotayitvāna sāsane;	tasmai dittam mama idāni sāsane 	tasmā dittaṃ mama idāni jotayitvāna sāsane
Karissaṃ me nisāmentu, sādhavo kavipuṅgavā.	karissam me sādhavaḥ kavi puṅgavā 	karissam me nisāmentu sādhavaḥ kavi puṅgavā
Jātattakīsotattakiyā vuttanayena asūro hutvā buddhattaṃ cintentasseva sattaasaṅkhyeyyāni	vutta nayena asūraḥ hutvā buddhattam cintentassa iva satta asaṅkhyeyyāni 	Jātattakīsotattakiyā vutta nayena asūraḥ hutvā buddhattam cintentassa iva satta asaṅkhyeyyāni
sabbakhaṇesu navamakhaṇattā ca tathā hi milakkhudesaarūpabhūmiasaññasattanirayapetatiracchānabhūmīsu	sabba khaṇesu navama khaṇa ttā ca tathā hi 	sabba khaṇesu navama khaṇa ttā ca tathā hi milakkhu desa arūpa bhūmi asañña satta niraya peta tiracchāna bhūmīsu
Micchādiṭṭhi tiracchāno, peto nerayikopica.	micchā diṭṭhi nerayikaḥ api ca 	micchā diṭṭhi tiracchāno peto nerayiko api ca
eko baddho hoti. Thero “idaṃ ṭhānaṃ aphāsukanti tato makuḷakārāmavihāraṃ nāma gato.	ekaḥ baddhaḥ hoti theraḥ idam ṭhānam tatas makuḷakārāmavihāram nāma gataḥ 	ekaḥ baddhaḥ hoti theraḥ idam ṭhānam aphāsukam iti tatas makuḷakārāmavihāram nāma gataḥ
parasamuddaṃ gacchāma, ito ca uttari lābhā nāma natthi, caturaṅgula mattāpi ghaṭikā	para samuddam gacchāma ito ca uttari lābhā nāma natthi ghaṭikā 	para samuddam gacchāma ito ca uttari lābhā nāma natthi catu aṅgula mattā api ghaṭikā
kuṇḍadhānatthero paṭhamaṃ salākaṃ aggahoti. Vāṇijagāmavāsinopi “sve kira satthā āgamissatī”ti	kuṇḍadhāna thero paṭhamam vāṇija gāma vāsinaḥ pi sve kira satthā āgamissati iti 	kuṇḍadhāna thero paṭhamam salākaṃ aggahoti vāṇija gāma vāsinaḥ pi sve kira satthā āgamissati iti
lañchanaṃ viya padacetiyaṃ dassesi. Evaṃ sūnāparantaraṭṭheyeva dve cakkaratanacetiyāni	lañchanam viya pada cetiyam dassesi evam dve cakka ratana cetiyāni 	lañchanam viya pada cetiyam dassesi evam sūnāparanta raṭṭhe yeva dve cakka ratana cetiyāni
yāvasāsanantaradhānaṃ patiṭṭhāpesi. Sattame pana vasse sāvatthiyaṃ kaṇḍambarukkhamūle	patiṭṭhāpesi sattame pana vasse sāvatthiyam kaṇḍamba rukkha mūle 	yāva sāsana antaradhānaṃ patiṭṭhāpesi sattame pana vasse sāvatthiyam kaṇḍamba rukkha mūle
vasi. Ekādasame nālandhabrāhmaṇagāme ekavāsaṃ vasi. Dvādasame verañjāyaṃ ekavāsaṃ	ekādasame nālandha brāhmaṇa gāme eka vāsam vasi dvādasame eka vāsam 	vasi ekādasame nālandha brāhmaṇa gāme eka vāsam vasi dvādasame verañjāyam eka vāsam
tathā hi gihibhāvato sāmaṇerabhāvo seṭṭho nāma, tatopi upasampannabhāvoyeva seṭṭho.	tathā hi gihi bhāvato sāmaṇeḥ abhāvaḥ seṭṭhaḥ nāma tatas pi seṭṭhaḥ 	tathā hi gihi bhāvato sāmaṇera bhāvo seṭṭho nāma tato pi upasampanna bhāvo eva seṭṭho
pana anusāvanānaṃ atthabyañjanabhedābhāvato atthabyañjanabhinnā ñatti tāsaṃ catutthanti	pana anusāvanānam attha byañjana bheda abhāvataḥ attha byañjana bhinnā tāsam 	pana anusāvanānam attha byañjana bheda abhāvato attha byañjana bhinnā ñatti tāsam catutthanti
vassasahassanti evaṃ pañcavassasahassāni paṭivedhasaddhammo tiṭṭhati. Pariyattisaddhammopi	evam pañca vassa sahassāni paṭivedha saddhammaḥ tiṭṭhati pariyatti saddhammaḥ api 	evam pañca vassa sahassāni paṭivedha saddhammo tiṭṭhati pariyatti saddhammopi
nikāyaṭṭhakathāsaṅgītiṃ ārūḷhā, atha kasmā evaṃ bhinnāti. Saccaṃ, tathāpi kesañci	nikāya ṭṭhakathā saṅgītim ārūḍhāḥ atha kasmai evam saccam tathā api kesañcid 	nikāya ṭṭhakathā saṅgītim ārūḷhā atha kasmā evam bhinnā iti saccam tathā api kesañci
na pavattiyaṃyevāti vadanti. Teneva ahetukapaṭisandhiniddese jaccandha-jaccabadhirādayo	na vadanti tena iva ahetuka paṭisandhi niddese 	na pavattiyaṃ yeva iti vadanti tena eva ahetuka paṭisandhi niddese jaccandha jaccabadhira ādayo
abhabbapuggale dassentena paṇḍakatiracchānagataubhato byañjanakā tayo vatthuvipannā	abhabba puggale dassentena vatthu vipannā 	abhabba puggale dassentena paṇḍaka tiracchāna gata ubhato byañjanakā tayo vatthu vipannā
asuddhacittena liṅgatthenakeeva paviṭṭhoti veditabbo. Yopi sāmaṇero vuḍḍhasāmaṇerānaṃ	asuddha cittena paviṭṭhaḥ iti veditabbaḥ yaḥ api sāmaṇeraḥ vuḍḍha sāmaṇerānam 	asuddha cittena liṅga atthena keva paviṭṭhaḥ iti veditabbaḥ yaḥ api sāmaṇeraḥ vuḍḍha sāmaṇerānam
tathā hi so saṃvāsaṃ sādiyantopi theyyasaṃvāsako na hoti, so sahaseyyādiāpattimpi	tathā hi saḥ saṃvāsam theyya saṃvāsakaḥ na hoti saḥ sahaseyya ādi āpattim pi 	tathā hi so saṃvāsaṃ sādiyanto pi theyya saṃvāsako na hoti so sahaseyya ādi āpattiṃ pi
tāvatiṃsabhavane sakko hutvā nibbatti, eko dhanañcayakorabyarañño aggamahesiyā kucchimhi	tāvatiṃsa bhavane sakkaḥ hutvā nibbatti ekaḥ aggamahesiyā kucchimhi 	tāvatiṃsa bhavane sakkaḥ hutvā nibbatti ekaḥ dhanañcaya korabya rañño aggamahesiyā kucchimhi
dukkhasmāti vadāmi. Punaca paraṃ brāhmaṇa idhekacco samaṇovā…pe… paṭijānamāno. Na	vadāmi punar ca param brāhmaṇaḥ idha ekaccaḥ samaṇovāpe paṭijānamānaḥ na 	dukkhasmāti vadāmi punar ca param brāhmaṇa idha ekaccaḥ samaṇovāpe paṭijānamānaḥ na
dukkhasmāti vadāmi. Punaca paraṃ brāhmaṇa idhekacco samaṇo vā…pe… na heva kho mātugāmena	vadāmi punaca param brāhmaṇaḥ idha ekaccaḥ samaṇaḥ vāpe na ha iva kho mātugāmena 	dukkhasmāti vadāmi punaca param brāhmaṇa idha ekacco samaṇo vā pe na heva kho mātugāmena
so tadassādeti…pe… dukkhasmāti vadāmi. Punaca paraṃ brāhmaṇa idhekacco samaṇovā brāhmaṇo	saḥ vadāmi punaca param brāhmaṇaḥ idha ekaccaḥ samaṇaḥ vā brāhmaṇaḥ 	saḥ tadassādeti pe dukkhasmāti vadāmi punaca param brāhmaṇa idha ekaccaḥ samaṇaḥ vā brāhmaṇaḥ
vā rodantiyā vā, so tadassādeti…pe… dukkhasmāti vadāmi. Punaca paraṃ brāhmaṇa idhekacco	vā rodantiyā vā saḥ dukkhasma ati vadāmi puna ca param brāhmaṇaḥ idha ekaccaḥ 	vā rodantiyā vā so tadassādeti pe dukkhasma ati vadāmi puna ca param brāhmaṇa idha ekacco
anussarati. So tadassā deti…pe… dukkhasmāti vadāmi. Punaca paraṃ brāhmaṇa idhekacco	anussarati saḥ tat assā dukkhasma ati vadāmi puna ca param brāhmaṇaḥ idha ekaccaḥ 	anussarati so tat assā deti pe dukkhasma ati vadāmi puna ca param brāhmaṇa idha ekacco
tadassādeti…pe… dukkhasmāti vadāmi. Punaca paraṃ brāhmaṇa…pe… na heva kho mātugāmena…pe…	dukkhasma ati vadāmi punaca param brāhmaṇape na ha iva khalu mātugāmenape 	tadassa ādeti pe dukkhasma ati vadāmi punaca param brāhmaṇa pe na ha iva khalu mātugāmena pe
kammāsampī”ti evaṃ lābhādihetukena bhedena ca sattavidhamethunasaṃyogena khaṇḍādibhāvo	evam lābha ādi hetukena bhedena ca sattavidha methuna saṃyogena khaṇḍa ādi bhāvaḥ 	kammāsampī ti evam lābha ādi hetukena bhedena ca sattavidha methuna saṃyogena khaṇḍa ādi bhāvo
chandarāgavasena antogehegatāva purisaṃ upanijjhāyati, rājorodho viya, sā tena gabbhaṃ	chanda rāga vasena purisam upanijjhāyati sā tena gabbham 	chanda rāga vasena anto geha gatā va purisam upanijjhāyati rāja orodho viya sā tena gabbham
jāto, sambhavena ajātattā. Pitughātakepi eseva nayo.	sambhavena a jāta ttā pitu ghātake pi eṣā iva nayaḥ 	jāto sambhavena a jāta ttā pitu ghātake pi esa eva nayo
karontassa itthinimittaṃ paṭicchannaṃ hoti, purisanimittaṃ pākaṭaṃ hoti. Purisaubhatobyañjanakassa	karontassa itthi nimittam paṭicchannam hoti purisa nimittam pākaṭam hoti 	karontassa itthi nimittam paṭicchannam hoti purisa nimittam pākaṭam hoti purisa ubhatobyañjanakassa
pākaṭaṃ. Itthiubhatobyañjanako sayañca gabbhaṃ gaṇhāti, parañca gaṇhāpeti. Purisa	pākaṭam sayam ca gabbham gaṇhāti param ca purisa 	pākaṭam itthiubhatobyañjanako sayam ca gabbham gaṇhāti param ca gaṇhāpeti purisa
tadā purisabyañjanaṃ pākaṭaṃ hoti, itthibyañjanaṃ paṭicchannaṃ tathā purisaubhatobyañjanakassapi.	tadā purisa byañjanam pākaṭam hoti itthi byañjanam paṭicchannam tathā 	tadā purisa byañjanam pākaṭam hoti itthi byañjanam paṭicchannam tathā purisa ubhato byañjanakassa api
Yadi tesaṃ indriyadvayaṃ byañjanānaṃ kāraṇaṃ bhaveyya, sadā byañjana dvayaṃ ekato	yadi indriya dvayam kāraṇam sadā 	yadi tesaṃ indriya dvayaṃ byañjanānaṃ kāraṇaṃ bhaveyya sadā byañjana dvayaṃ ekato
ayuttova. Kasmā, pavattiyaṃyeva itthiliṅgādīni samuṭṭhahanti. Paṭisandhiyameva samuṭṭhāti,	kasmā itthi liṅga ādīni samuṭṭhahanti paṭisandhiyam eva samuṭṭhāti 	ayutto va kasmā pavattiyaṃ yeva itthi liṅga ādīni samuṭṭhahanti paṭisandhiyam eva samuṭṭhāti
na liṅgādīni. Indriyameva liṅganti na sakkā vattuṃ, indriyaliṅgānaṃ bhinnasabhāvattā,	na liṅga ādīni indriyam eva liṅganti na sakkā vattum 	na liṅga ādīni indriyam eva liṅganti na sakkā vattuṃ indriya liṅgānaṃ bhinna sabhāvattā
Sambandhaṃ vavatthitaṃ vimuttaṃ, dasadhā byañjanabuddhiyā pabhedo”ti.	sambandham vavatthitam vimuttam dasadhā 	sambandham vavatthitam vimuttam dasadhā byañjanabuddhiyā pabhedo ti
aparāmasanāni pacchā ñattiṭṭhapanañcāti ime tāva pañca ñattidosā. Tattha ayaṃ itthanāmoti	pacchā ime tāva pañca tattha ayam itthanāmā ti 	aparāmasanāni pacchā ñattiṭṭhapanañcāti ime tāva pañca ñattidosā tattha ayaṃ itthanāmoti
catukkhattuṃ ñattikittanameva vā kammavācabbhantarepi cattāri byañjanāni kopetvā	catu khattum ñatti kittanam eva vā cattāri byañjanāni kopetvā 	catu khattum ñatti kittanam eva vā kamma vācā abbhantare pi cattāri byañjanāni kopetvā
pana sātisāro tenevāha vimativinodaniyampi pattacīvarānaṃ abhāvepi’paripuṇṇassa pattacīvara’nti	pana sa atisāraḥ tena iva āha patta cīvarānaṃ abhāve pi paripuṇṇassa 	pana sa atisāraḥ tena eva āha vimativinodaniyam pi patta cīvarānaṃ abhāve pi paripuṇṇassa patta cīvara nti
paṇḍakādikena vināva pañcavaggādigaṇo pūrati, kammaṃ na kuppati. Itarathā kuppatī”ti.	paṇḍaka ādikena pūrati kammam na kuppati itarathā kuppati iti 	paṇḍaka ādikena vināva pañcavaggādigaṇo pūrati kammam na kuppati itarathā kuppati iti
Pāliphullo mahāsālo, ucco merunagūpamo;	pāliphullaḥ mahā sālaḥ uccaḥ meru nagu upamaḥ 	pāliphullaḥ mahā sālaḥ uccaḥ meru nagu upamaḥ
Dharanteyeva sambuddhe, bhinnavādo avisayo.	sambuddhe bhinna vādaḥ a visayaḥ 	Dharante yeva sambuddhe bhinna vādaḥ a visayaḥ
sammatā. Tassāvitthāro ''paṭhamaṃ nimittā kittetabbā''ti ādinā dvāsattatippabhedāya	paṭhamam nimittā ādinā dvāsattati pabhedāya 	paṭhamam nimittā kittetabbā ti ādinā dvāsattati pabhedāya
na otaratīti ime dve ekatthā byañjanameva nānaṃ. Ayañhetthatthouparimassa sīmāparicchedassa	na otarati iti ime dve ekatthā byañjanam eva sīmā paricchedassa 	na otarati iti ime dve ekatthā byañjanam eva nānaṃ ayaṃ hi ettha attho uparimassa sīmā paricchedassa
vasanti, ayameva upacārasīmāti adhippetā. Bhikkhūnaṃ vassūpagamanakathinatthārakaraṇaṭṭhānattā,	vasanti ayam eva upacāra sīmā ti adhippetā bhikkhūnam 	vasanti ayam eva upacāra sīmā ti adhippetā bhikkhūnam vassūpagamana kathina tthāra karaṇa ṭṭhānattā
tathā hi “kathinatthatasīmāya”nti upacārasīmaṃ sandhāya vuttaṃ, khandhasīmāya tatruppādābhāvatoti	tathā hi upacāra sīmam sandhāya vuttam khandha sīmāya tatra uppāda abhāvato ti 	tathā hi kathinatthata sīmāya nti upacāra sīmam sandhāya vuttam khandha sīmāya tatra uppāda abhāvato ti
tīsupi gaṇṭhipadesu vuttaṃ. Tatruppādenā bhatanti vihārasantakena khettavatthuādinā	tīsu pi gaṇṭhi padesu vuttam vihāra santakena khetta vatthu ādinā 	tīsu pi gaṇṭhi padesu vuttaṃ tatruppādenā bhata nti vihāra santakena khetta vatthu ādinā
tasmā kathinatthatasīmāyaṃ anuddhaṭe kathine yāva phagguṇapuṇṇamā pañca māsā etthantare	an uddhaṭe kathine yāva phagguṇa puṇṇamā pañca māsāḥ etthantare 	tasmā kathina atthata sīmāyaṃ an uddhaṭe kathine yāva phagguṇa puṇṇamā pañca māsāḥ etthantare
Kathinatthatasāṭakassa dānakammavācā pana khaṇḍasīmāyameva vaṭṭasi. Tasmiṃ vihāre	dāna kamma vācā pana khaṇḍa sīmāyam eva vaṭṭasi tasmin vihāre 	kathina atthata sāṭakassa dāna kamma vācā pana khaṇḍa sīmāyam eva vaṭṭasi tasmiṃ vihāre
Kasmāti ce, tasmiṃ vihāre purimikāya upagatā kathinatthārakusalā na honti. Atthārakusalā	kasmāti ce tasmin vihāre purimikāya upagatā na honti atthāra kusalā 	kasmāti ce tasmin vihāre purimikāya upagatā kathinatthārakusalā na honti atthāra kusalā
idaṃ aṭṭhakathāyaṃ vicāritaṃ. Apare pana “kathinatthatasīmanti upacārasīmaṃ sandhāya	idam aṭṭhakathā ayam vicāritam apare pana upacāra sīmam sandhāya 	idam aṭṭhakathā ayam vicāritam apare pana kathinatthata sīmanti upacāra sīmam sandhāya
vutta”nti vuttattā upacārasīmāyameva kathinanatthāraka ñattiṃ karonti, taṃ ayuttaṃ,	vuttam ti vutta ttā upacāra sīmāyam eva ñattim karonti tam ayuttam 	vuttam ti vutta ttā upacāra sīmāyam eva kathina atthāraka ñattim karonti tam ayuttam
bhikkhū tattha pāsānayanaṃ vā bahisīmakaraṇaṃ vā ko sakkhissati. “Kathinatthatasīmāya”nti	bhikkhū tattha pāsā nayanam vā bahi sīmakaraṇam vā kaḥ sakkhissati 	bhikkhū tattha pāsā nayanam vā bahi sīmakaraṇam vā ko sakkhissati kathinatthatasīmāyanti
imināpipadena kathinatthatabhāvoyeva vutto, na kathinatthatasāṭakassa dānakammavācā,	iminā api padena vuttaḥ na dāna kamma vācā 	iminā api padena kathinatthata bhāvo yeva vutto na kathina atthata sāṭakassa dāna kamma vācā
Kathinatthatasāṭakadānepi anatthateyeva kathine tato bahuānisaṃsacīvarasāṭakaṃ labhitvā	kathinatthata sāṭaka dāne pi kathine tatas labhitvā 	kathinatthata sāṭaka dāne pi anatthate yeva kathine tato bahu ānisaṃsa cīvara sāṭakaṃ labhitvā
saṅghassa anumatiyā dātabbaṃ. Kathinatthatasāṭakadānakammavācā ekā ce vaṭṭati. Puna	saṅghassa anumatiyā dātabbam ekā ce vaṭṭati puna 	saṅghassa anumatiyā dātabbam kathinatthatasāṭakadānakammavācā ekā ce vaṭṭati puna
sammatā sīmā, etā dvesīmā tiyojanaparamatāyapi sambhavato mahāsīmā tipi nāmaṃ labhanti,	sammatā sīmā etāḥ sambhavataḥ mahāsīmā nāmam labhanti 	sammatā sīmā etā dve sīmā tiyojanaparamatāya api sambhavato mahāsīmā ti pi nāmam labhanti
aññesaṃ dammīti adatvā puggale mate saṅghiko hoti, udāhu puggalikoyevāti. Tatrāyaṃ	aññesam dammi iti a datvā puggale mate saṅghikaḥ hoti udāhu tatra ayam 	aññesam dammi iti a datvā puggale mate saṅghiko hoti udāhu puggaliko eva iti tatra ayam
na puggalassa, khettādi viya daṭṭhabba”nti. Tatrāyaṃ yojanā vihārassādemāti vatvā	na puggalassa khetta ādi viya daṭṭhabbanti tatra ayam yojanā vatvā 	na puggalassa khetta ādi viya daṭṭhabbanti tatra ayam yojanā vihārassa āde mā iti vatvā
pana udakaparibhogatthaṃ kūpapokkharaṇīādayo vaṭṭanti. Saṅghassataḷākaṃatthi, taṃkathantiādināhisabbattha	pana udaka paribhoga attham kūpa pokkharaṇī ādayaḥ vaṭṭanti tam katham ti ādinā hi sabbattha 	pana udaka paribhoga attham kūpa pokkharaṇī ādayo vaṭṭanti saṅghassa taḷākam atthi tam katham ti ādinā hi sabbattha
taditarānaṃ tathāgahetabbatā siddhāva hotī’ti vuttaṃ, tasmā taḷākakhettavatthādisahitassa	tathāgahetabba tā siddhau a hoti iti vuttam tasmā taḷāka khetta vattha ādi sahitassa 	taditarānaṃ tathāgahetabba tā siddhā va hoti iti vuttaṃ tasmā taḷāka khetta vattha ādi sahitassa
Ettha ca yaṃ tattha garubhaṇḍa’nti ādīsu garubhaṇḍaṃ nāma rāsivasena pañcavidhaṃ,	ca yam tattha ādīsu garubhaṇḍam nāma rāsi vasena pañcavidham 	Ettha ca yam tattha garubhaṇḍa'nti ādīsu garubhaṇḍam nāma rāsi vasena pañcavidham
Pañcavīsavidhaṃ nātho, garubhaṇḍaṃ pakāsayīti.	pañcavīsavidham nā atho garubhaṇḍam 	pañcavīsavidham nātho garubhaṇḍam pakāsayīti
tathā sūnāparantaraṭṭhavāsinopi mahātherā tathā isinagaravāsinopi mahātherā puggalikabhāvena	tathā mahā therā tathā isi nagara vāsinaḥ api mahā therā puggalika bhāvena 	tathā sūnāparanta raṭṭha vāsino api mahā therā tathā isi nagara vāsino api mahā therā puggalika bhāvena
gāmūpacārañcā’ti ettha viruddhasenāsanaṃ ṭhapetvā sabbakappiyākappiyaṃ vihārassa	ettha viruddha senāsanam ṭhapetvā sabba kappiya akappiyam vihārassa 	gāmūpacārañcā'ti ettha viruddha senāsanam ṭhapetvā sabba kappiya akappiyam vihārassa
na vaṭṭatī”ti sāratthadīpaniyaṃ vutta vacanenāpi avirodho siyā, tathā “senāsane kiñci	na vaṭṭati iti vacanena api avirodhaḥ siyā tathā senāsane kiñci 	na vaṭṭati iti sāratthadīpaniyaṃ vutta vacanena api avirodhaḥ siyā tathā senāsane kiñci
paṭisedhetabbaṃ natthi aññatra viruddhasenāsananā”ti aṭṭhakathāvacanenāpi saṃsandameva.	paṭisedhetabbam natthi aññatra aṭṭhakathā vacanena api saṃsandam eva 	paṭisedhetabbam natthi aññatra viruddhasenāsananā ti aṭṭhakathā vacanena api saṃsandam eva
akappiyaṃ paṭibāhati, taṃ vo kappatī”ti iminā suttānulomenapisaṃndameva. Kathaṃ “anujānāmi	akappiyam paṭibāhati tam vaḥ kappati iti iminā katham anujānāmi 	akappiyam paṭibāhati tam vo kappati iti iminā suttānulomena pi sandam eva katham anujānāmi
aññadatthu gaṅgodakena yamunodakaṃ viya khettavatthādisahitavihāro puggalikabhāvenāpi	gaṅgā udakena yamunā udakam viya khetta vattha ādi sahita vihāro puggalika bhāvena api 	aññadatthu gaṅgā udakena yamunā udakam viya khetta vattha ādi sahita vihāro puggalika bhāvena api
Yadi chejjabhejjakaro bhaveyya, rājātveva saṅkhyaṃ gacchati. Sopi gāmadeso nagararajjasīmā	yadi chejjabhejja karaḥ rājā atu eva saṅkhyam gacchati saḥ api gāma desaḥ nagara rajja sīmā 	yadi chejjabhejja karo bhaveyya rājā tu eva saṅkhyam gacchati so api gāma deso nagara rajja sīmā
mahanto vā, gāmasīmātveva saṅkhyaṃ gacchati. Nagaranigamasīmāsupi eseva nayo”ti.	mahantaḥ vā gāma sīmā tu eva saṅkhyam gacchati nagara nigama sīmā supi 	mahantaḥ vā gāma sīmā tu eva saṅkhyam gacchati nagara nigama sīmā supi esa eva nayo ti
sattabbhantarāti yasmiṃ viñjhāṭavisadise araññe bhikkhu vasati, athassa ṭhitokāsato	yasmin viñjhāṭa visadise araññe bhikkhu vasati athassa ṭhita ukāsataḥ 	sattabbhantarāti yasmin viñjhāṭa visadise araññe bhikkhu vasati athassa ṭhita okāsato
hatthappamāṇaṃ hoti, tasmā puratthimāya sattabbhantare channavutisatahatthappamāṇaṃ	hattha ppamāṇam hoti tasmai puratthimāya channavuti sata hattha ppamāṇam 	hattha ppamāṇam hoti tasmā puratthimāya sattabbhantare channavuti sata hattha ppamāṇam
“Pañcahattho mato daṇḍo, vīsadaṇḍo usabho;	pañca hatthaḥ mataḥ daṇḍaḥ vīsa daṇḍaḥ usabhaḥ 	pañca hattho mato daṇḍo vīsa daṇḍo usabho
Sabbaṃ aṭṭhavīsati abbhantaraṃ sampiṇḍetvā catuhatthādhikachappaññāsuttara ekasataṃ	sabbam aṭṭhavīsati abbhantaram sampiṇḍetvā ekasatam 	sabbam aṭṭhavīsati abbhantaram sampiṇḍetvā catuhatthādhikachappaññāsuttara ekasatam
hoti. Parimaṇḍalavasena pana chahatthādhikacatutiṃsuttaradvesatāni honti, usabhavasena	hoti parimaṇḍala vasena pana honti usabha vasena 	hoti parimaṇḍala vasena pana chahatthādhikacatutiṃsuttaradvesatāni honti usabha vasena
bhaveyya, aṭṭhakathāyaṃ tattha abbhantaraṃ nāma aṭṭhavīsatihatthappamāṇaṃ hoti, majjhe	tattha abbhantaram nāma aṭṭhavīsati hattha ppamāṇam hoti majjhe 	bhaveyya aṭṭhakathāyaṃ tattha abbhantaram nāma aṭṭhavīsati hattha ppamāṇam hoti majjhe
Dve vidatthitu ratanaṃ, sattahatthaṃ ekayaṭṭhi;	dve ratanam satta hattham eka yaṭṭhi 	dve vidatthi tu ratanam satta hattham eka yaṭṭhi
Vīsayaṭṭhitu usabhaṃ, usabhāsīti gāvutaṃ;	usabham usabhā asi iti gāvutam 	Vīsa yaṭṭhi tu usabham usabhā asi iti gāvutam
Vuttattā dasakesā ekaṃ tilaṃ nāma. Chatilaṃ ekaṃ yavaṃ nāma. Catuyavaṃ ekāaṅguli	vutta ttā dasa kesāḥ ekam tilam nāma cha tilam ekam yavam nāma catu yavam 	vutta ttā dasa kesāḥ ekam tilam nāma cha tilam ekam yavam nāma catu yavam ekā aṅguli
Trimuṭṭhi ekaratanaṃ, aṭṭhavīsatiratanaṃ ekaṃabbhantaranti.	eka ratanam aṭṭhavīsati ratanam 	Trimuṭṭhi eka ratanam aṭṭhavīsati ratanam ekam abbhantaran ti
rājā”tiādīsu sadise. “Amala”nti ādīsu viruddhe. “Aseṭṭhoyaṃ brāhmaṇo abrahmacārī”ti	rājā ati ādīsu sadise ādīsu viruddhe a seṭṭhaḥ yam brāhmaṇaḥ a brahmacārī iti 	rājā ati ādīsu sadise amala iti ādīsu viruddhe a seṭṭhaḥ yam brāhmaṇaḥ a brahmacārī iti
nimanusse kevalāraññeti attho. Virahattho vā agāmake gāmavirahite padeseti attho	kevala araññā iti atthaḥ viraha atthaḥ vā agāmake gāma virahite padese iti atthaḥ 	nimanusse kevalāraññe iti attho viraha attho vā agāmake gāma virahite padese iti attho
daṭṭhabbo. Teneva suññatthena virahatthena “agāmake”timināpadena gāmanadījātassarasamudde	daṭṭhabbo tena iva suñña tthena viraha tthena gāma nadī jāta ssara samudde 	daṭṭhabbo teneva suñña tthena viraha tthena agāmake ti imina padena gāma nadī jāta ssara samudde
ajaṭākāsepi labbhateva. Nanu chakāmāvacara devalokesupi devavimānakapparukkhagāmanigamādayopi	ajaṭā kāse pi deva vimāna kappa rukkha gāma nigama ādayaḥ pi 	ajaṭā kāse pi labbhati eva nanu cha kāmāvacara deva lokesu pi deva vimāna kappa rukkha gāma nigama ādayaḥ pi
thāmamajjhimassa purisassa tenevāha samantapākādikāya vinayaṭṭhakathāyaṃ “thāmamajjhimena	thāma majjhimassa purisassa tena iva āha samanta pāka ādikāya thāma majjhimena 	thāma majjhimassa purisassa tena eva āha samanta pāka ādikāya vinaya aṭṭhakathāyaṃ thāma majjhimena
kāyabalaṃ. “Nārāyanasaṅkhātaṃ bala”ntipi idameva vuccati. Tattha nārā vuccanti rasmiyo,	kāya balam nārāyana saṅkhātam idam eva vuccati tattha nārāḥ vuccanti 	kāya balaṃ nārāyana saṅkhātaṃ balaṃ ti pi idam eva vuccati tattha nārā vuccanti rasmiyo
minetuṃ abhabbo, antamaso pādaṅguṭṭha so pādaṅguṭṭhakampi gaṇhetuṃ abhabbova. Tassa	minetum abhabbaḥ saḥ pādaṅguṭṭhakam pi gaṇhetum abhabbaḥ uva tassa 	minetuṃ abhabbo antamaso pādaṅguṭṭha so pādaṅguṭṭhakam pi gaṇhetuṃ abhabbo eva tassa
nādhippetā. Kasmā kuṭikārasikkhāpadeyeva tihatthāti vaḍḍhakihatthena tihatthā. Pamāṇayutto	na adhippetā kasmā ti hatthā ati vaḍḍhaki hatthena ti hatthā pamāṇa yuttaḥ 	na adhippetā kasmā kuṭikāra sikkhāpade yeva ti hatthā ati vaḍḍhaki hatthena ti hatthā pamāṇa yutto
idha avatvā’thāmamajjhimena purisenā’ti aṭṭhakathāyaṃ vuttattā. Pakatipuriso nāma’yaṃ	idha purisena ati aṭṭhakathā ayam vutta ttā pakati purisaḥ nāma ayam 	idha avatvā atha majjhimena purisena iti aṭṭhakathāyaṃ vuttattā pakati puriso nāma ayaṃ
sīmā samānasaṃvāsāceva ekūposathācā’ti atthayojanaṃ katvā ayaṃ etesaṃ nadīādīnaṃ	sīmā attha yojanam katvā ayam etesam nadī ādīnam 	sīmā samāna saṃvāsā ceva ekūposathā cā ti attha yojanam katvā ayam etesam nadī ādīnam
na gacchati, antoyeva gacchati, tasmā tesaṃ antoparisapariyantato paṭṭhāya samantāudakukkhepa	na gacchati antar yā iva gacchati tasmā tesam paṭṭhāya 	na gacchati antoyeva gacchati tasmā tesaṃ antoparisapariyantato paṭṭhāya samantā udakukkhepa
sīmāparicchedadassanatthaṃ vuttaṃ, ticīvarena vippavāsaparicchedadassanatthampi sattabbhantarasīmāya	sīmā pariccheda dassana attham vuttam ti cīvarena vippavāsa pariccheda dassana attham pi 	sīmā pariccheda dassana attham vuttam ti cīvarena vippavāsa pariccheda dassana attham pi satta abbhantara sīmāya
majjhimapuriso na ñāyati, tathā sabbathāmena khipana”nti vā, “etadatthameva hi vālikādīhi	majjhima purisaḥ na vā etad attham eva hi vālikā ādīhi 	"majjhima puriso na ñāyati tathā sabbathāmena khipana""nti vā etad attham eva hi vālikā ādīhi"
sīmaparicchindana”nti vā vimativinodanīvacanehi vā na sameti. Ganthakārenāpi parūpavādavivajjanatthaṃ	vā vimati vinodanī vacanehi vā na sameti ganthakārena api 	"sīma paricchindana""nti vā vimati vinodanī vacanehi vā na sameti ganthakārena api parūpavāda vivajjanatthaṃ"
akkhasaddo hi jūtepi nirūḷho. Dāruguḷanti bhamaṃ āropetvā āraggena katadāruvikati	akkha saddaḥ hi jūte pi nirūḍhaḥ bhamam āropetvā āraggena 	akkha saddaḥ hi jūte pi nirūḍhaḥ dāru guḷam ti bhamam āropetvā āraggena kata dāru vikati
attho. Ayañhetthattho sace nadī nātidīghā hoti aḍḍhayojanaṃ vā gāvutaṃ vā aḍḍhagāvutaṃ	atthaḥ sace nadī na ati dīghā hoti aḍḍha yojanam vā gāvutam vai aḍḍha gāvutam 	attho ayam hi ettha attho sace nadī na ati dīghā hoti aḍḍha yojanam vā gāvutam vā aḍḍha gāvutam
ubhayatthāpi ca. Yassaṃ disāyaṃ sattabbhantarassa vā udakukkhepassa vā okāso nappahoti,	ubhayattha api ca disā ayam okāsaḥ nappahoti 	ubhayattha api ca yassam disayam sattabbhantarassa va udakukkhepassa va okaso nappahoti
aghaṭiyattā ca pāḷiyaṭṭhakathāṭīkāvacanehipi virujjhanato ca, taṃ parato vaṇṇayissāma.	ca virujjhanataḥ ca tam paratas vaṇṇayissāma 	aghaṭiyattā ca pāḷiyaṭṭhakathāṭīkāvacanehipi ca virujjhanato ca taṃ parato vaṇṇayissāma
uppajjanti, nāsatīti daṭṭhabba’nti vuttattā udakukkhepaṃ vināva parisapariyantato	uppajjanti na asati iti daṭṭhabban ti vutta ttā udakukkhepam vinā ava 	uppajjanti na asati iti daṭṭhabban ti vutta ttā udakukkhepam vinā va parisapariyantato
vinayaṭṭhakathāsuceva sāratthadīpaniyañca vuttavacanehipi tava vacanaṃ asaṃsandeva,	vinaya ṭṭhakathāsu ca iva vutta vacanehi pi tava vacanam 	vinaya ṭṭhakathāsu ca eva sāratthadīpaniyañ ca iva vutta vacanehi pi tava vacanam asaṃsand eva
vimativinodaniyameva parato vuttavacanenāpi na ghaṭiyati. Kathaṃ neyyavacanaṃ hotīti.	vimati vinoda niyam eva paratas vutta vacanena api na katham neyya vacanam hoti iti 	vimati vinoda niyam eva paratas vutta vacanena api na ghatiyati katham neyya vacanam hoti iti
“Sīmāpekkhāya sati eva…pe… nassatī”ti ettha sīmāpekkhāya vinā maggagamananhānādi	sīmā apekkhāya sati ettha sīmā apekkhāya vinā 	sīmā apekkhāya sati eva pe nassati iti ettha sīmā apekkhāya vinā magga gamananhānādi
uppajjati’ nadīsamuddajātassaresupi majjhimassa purisassa samantā udakukkhe’pāti	uppajjati majjhimassa purisassa samantā 	uppajjati nadīsamuddajātassaresupi majjhimassa purisassa samantā udakukkhe'pāti
sati vimativinodaniyaṃ yeva puna tatthāti lokavohārasiddhāsu etāsu nadīādīsu tīsu	sati loka vohāra siddhāsu etāsu nadī ādīsu tīsu 	sati vimati vinodaniyaṃ yeva puna tattha iti loka vohāra siddhāsu etāsu nadī ādīsu tīsu
khipiyati etthāti udakukkhepo, udakassa pathanokāso, tasmā udakukkhepā. Ayañhettha	ettha ati udakukkhepaḥ udakassa pathanokāsaḥ tasmai udakukkhepāḥ ayam ha ittha 	khipiyati ettha ati udakukkhepaḥ udakassa pathanokāsaḥ tasmai udakukkhepāḥ ayam hi ettha
bhaveyya ācariyameva hi kecipana samantā abbhantaraṃ minitvā paricchedakaraṇeneva	bhaveyya hi samantā abbhantaram minitvā pariccheda karaṇena iva 	bhaveyya ācariyam eva hi keci pana samantā abbhantaram minitvā pariccheda karaṇena eva
sīmā sañjāyati, na sayamevāti vadanti, taṃ na gahetabbhantyādinā kecivādaṃ paṭikkhipitvā	sīmā sañjāyati na sayam eva ati vadanti tam na keci vādam paṭikkhipitvā 	sīmā sañjāyati na sayam eva iti vadanti taṃ na gahetabbaṃ iti ādinā keci vādaṃ paṭikkhipitvā
leḍḍusuppādikhipanavijānanadassanaṃ viya, teneva mātikāṭṭhakathāyaṃ sīmaṃ vā bandhanti	leḍḍu suppa ādi khipana vijānana dassanam viya tena iva sīmam vā bandhanti 	leḍḍu suppa ādi khipana vijānana dassanam viya tena eva mātikā aṭṭhakathāyam sīmam vā bandhanti
tāsaṃ sattabbhantaraudakukkhepasīmānaṃ uppatti, tabbigamena vināso ca gahetabboti	tāsam uppatti tad vigamena vināsaḥ ca gahetabbaḥ ti 	tāsaṃ sattabbhantaraudakukkhepasīmānaṃ uppatti tad vigamena vināso ca gahetabbo ti
attho labbhate mātikāṭṭhakathāya līnatthappakāsaniyampi “samantā udakukkhepaparicchedo	atthaḥ labbhate mātikā aṭṭhakathāya samantā udakukkhepa paricchedaḥ 	atthaḥ labbhate mātikā aṭṭhakathāya līnatthappakāsaniyampi samantā udakukkhepa paricchedaḥ
aññamaññaviruddhaṃ viya dissati vimativinodaniyaṃyeva ca “mahoghena pana unnataṭṭhānato	aññam añña viruddham viya dissati ca mahā oghena pana unnata ṭṭhānato 	aññam añña viruddham viya dissati vimati vinodaniyam yeva ca mahā oghena pana unnata ṭṭhānato
nadījātassaraudakukkhepāti dve dve sīmā labbhanti samudde pana kasmā samuddaudakukkhepavasena	dve dve sīmāḥ labbhanti samudde pana kasmā samudda odakukkhepa vasena 	nadī jāta ssara udakukkhepa āti dve dve sīmāḥ labbhanti samudde pana kasmā samudda udakukkhepa vasena
vattabbaṃ siyā nanevaṃ vuttaṃ. Athavā pakaraṇādivasena saddatthe vibhajjīyamānepi	vattabbam siyā nanu ivam vuttam athavā pakaraṇa ādi vasena saddatthe 	vattabbam siyā nanu evam vuttam athavā pakaraṇa ādi vasena saddatthe vibhajjīyamāne api
ekagabbheneva maranti tasmā “vaḷavaṃ savaccha”ntivā avaccha”nti vā vattuṃ nārahati	eka gabbhena iva maranti tasmai vaḷavam a vacchanti vā vattum na ārahati 	eka gabbhena eva maranti tasmā vaḷavam sa vacchanti vā a vacchanti vā vattum na ārahati
apica vimativinodaniyaṃyeva “gacchantiyā pana nāvāya kātuṃ na vaṭṭati. Kasmā udakukkhepamattameva	apica gacchantiyā pana nāvāya kātum na vaṭṭati kasmai uda kukkhepa mattam eva 	apica vimativinodaniyaṃ yeva gacchantiyā pana nāvāya kātuṃ na vaṭṭati kasmā udakukkhepamattam eva
kathinatthatasāṭakadānakammavācāviya tathā hi kathinatthatasāṭakadānakāle vuttakammavācā	tathā hi kathinattha tasa āṭaka dāna kamma vācā 	tathā hi kathinatthata sāṭaka dāna kamma vācā viya tathā hi kathinatthata sāṭaka dāna kāle vutta kamma vācā
ekāyevavaṭṭati, atthateyeva kathine puna varasāṭakaṃ labhitvā kammavācāya dānakiccaṃ	kathine puna vara sāṭakam labhitvā kamma vācāya dāna kiccam 	ekā yeva vaṭṭati attha te yeva kathine puna vara sāṭakam labhitvā kamma vācāya dāna kiccam
ime dve saddaracanāpi asambandhāva bhinnalakkhaṇā bhinnavisayā cetā sīmā. Kathaṃ	ime dve bhinna lakkhaṇā bhinna visayā sīmā kathaṃ 	ime dve saddaracanāpi asambandhāva bhinna lakkhaṇā bhinna visayā cetā sīmā kathaṃ
kammaṃ. Kiṃ taṃ, khipanaṃ. Evampi saddaracanā asambandhāva. “Vaggakammaparihāratthaṃ…pe…	kammam kim tam khipanam evam pi 	kammam kim tam khipanam evam pi saddaracana asambandha va vaggakammapariharam attham pe
Yadi hi…pe… yathā cettha, evaṃ udakukkhepasīmāyapi nadīādīsupi tatthāpi hi majjhimapuriso	yadi hipe yathā ca ittha evam nadī ādīsu pi tattha api hi majjhima purisaḥ 	yadi hi pe yathā ca ettha evaṃ udakukkhepasīmāya pi nadī ādīsu pi tattha api hi majjhima puriso
viharati, tassa araññassa araññasīmāti nānuññātā tathā nadīsamuddajātassaresupi gāmasīmāyamiva	viharati tassa araññassa arañña sīmā ati na anuññātā tathā gāma sīmāyam iva 	viharati tassa araññassa arañña sīmā ati na anuññātā tathā nadī samudda jātassaresu pi gāma sīmāyam iva
vā mahanto vā sabbo gāmapadeso gāmasīmāva hoti, sattabbhantarasīmāyapi “samantā sattabbhantarā”ti	vā mahantaḥ vā sabbaḥ gāma padesaḥ gāma sīmā ava hoti samantā sattabbhantarā ati 	vā mahantaḥ vā sabbaḥ gāma padesaḥ gāma sīmā ava hoti sattabbhantara sīmāya api samantā sattabbhantarā ati
uppajjatī”ti minanāminanavicāraṇā pana niratthakāva tathā udakukkhepasīmāyapi “majjhimassa	uppajjati iti minana aminana vicāraṇā pana niratthakā eva tathā majjhimassa 	uppajjati iti minana aminana vicāraṇā pana niratthakā eva tathā udakukkhepasīmāya api majjhimassa
bhinnavisayāva tasmā “nadīādīsu eseva nayo”ti vuttepi sattabbhantarasīmā apekkhāya	bhinna visayā ava tasmā nadī ādīsu esā iva nayo ti vutte pi 	bhinna visayā ava tasmā nadī ādīsu esa eva nayo ti vutte pi satta abbhantara sīmā apekkhāya
ce. Taṃ na, mātikāṭṭhakathāyaṃ “sace pana dvesaṅghā visuṃvisuṃ uposathādikammaṃ karonti,	ce tam na sace pana dvi saṅghāḥ visum visum uposatha ādi kammam karonti 	ce tam na mātikā aṭṭhakathāyam sace pana dvi saṅghāḥ visum visum uposatha ādi kammam karonti
na aṭṭhakathāyaṃ upalabbhati. Yadi cetaṃ dvinnaṃ saṅghānaṃ visuṃvisuṃ uposathādikammakaraṇādhikāre	na upalabbhati yadi ca itam dvinnam saṅghānam visum visum uposatha ādi kamma karaṇa adhikāre 	na aṭṭhakathāyaṃ upalabbhati yadi ca etaṃ dvinnaṃ saṅghānaṃ visuṃ visuṃ uposatha ādi kamma karaṇa adhikāre
paricchedanti dutiyaṃ udakukkhepaṃ anatikkamantopi kopeti. Kasmā, attano udakukkhepasīmāya	dutiyam udakukkhepam an atikkamantaḥ api kopeti kasmai attanaḥ udakukkhepa sīmāya 	paricchedanti dutiyam udakukkhepam an atikkamantopi kopeti kasma attano udakukkhepa simaya
paresaṃ udakukkhepasīmāya ajjhotthatattā sīmāsambhedo hoti, tasmā kopetī’ti “idaṃ	paresam udakukkhepa sīmāya sīmā sambhedaḥ hoti tasmā kopeti iti idam 	paresam udakukkhepa sīmāya ajjhotthatattā sīmā sambhedaḥ hoti tasmā kopeti iti idam
sāratthadīpaniyaṃyeva imamatthaṃ daḷhikaraṇavasena udakukkhepappamāṇā sīmantarikā	imamattham daḷhi karaṇa vasena uda kukkhepa ppamāṇā sīmantarikā 	sāratthadīpaniyaṃyeva imamatthaṃ daḷhi karaṇa vasena uda kukkhepa ppamāṇā sīmantarikā
Raṭṭhasīmā nāma kāsikosalādikā soḷasa mahājanapadā. “Soḷasamahānagara”ntipi tesaṃ	raṭṭhasīmā nāma kāsi kosala ādikā soḷasa mahā janapadā tesam 	raṭṭhasīmā nāma kāsi kosala ādikā soḷasa mahā janapadā soḷasa mahā nagara nti pi tesam
nāma tadaññepi sunāparantaraṭṭhādikā bahutarāva. Tathā paccantavisayepi rāmaññādikā	nāma tad aññe pi bahutarā ava tathā paccanta visaye pi rāmañña ādikā 	nāma tad aññe pi sunāparanta raṭṭha ādikā bahutarā ava tathā paccanta visaye pi rāmañña ādikā
“Pavattā catuvaṇṇānaṃ, yasmiṃ padese na vijjate;	pavattā yasmin padese na vijjate 	pavattā catuvaṇṇānaṃ yasmiṃ padese na vijjate
āharitvā kātuṃ sakkuṇeyyabhāvoyeva pamāṇaṃ. Evamasakkonte aniddhimapuggale sandhāya	āharitvā kātum pamāṇam evam a sakkonte aniddhim apuggale sandhāya 	āharitvā kātuṃ sakkuṇeyyabhāvoyeva pamāṇaṃ evaṃ asakkonte aniddhiṃ apuggale sandhāya
sattabbhantarasīmā attano sabhāveneva jātā tathā nadīsamuddajātassaresupi majjhimassa	satta abbhantara sīmā sabhāvena iva jātā tathā majjhimassa 	satta abbhantara sīmā attano sabhāvena eva jātā tathā nadī samudda jāta saresu pi majjhimassa
nuññātasuttānulomanayasāmatthiyato khuddakesu gāmanigamajanapadanagaresu tattha tattha	khuddakesu gāma nigama janapada nagaresu tattha tattha 	nuññāta suttānuloma naya sāmatthiyato khuddakesu gāma nigama janapada nagaresu tattha tattha
Karissaṃ me nisāmentu, sādhavo kavipuṅgavā.	karissam me sādhavaḥ kavi puṅgavā 	karissam me nisāmentu sādhavaḥ kavi puṅgavā
nisinno hoti, kārakasaṅgho sāvajjo, kammaṃpana na kuppati kasmā avaggārahattā. Aparepana	nisinnaḥ hoti kāraka saṅghaḥ sāvajjaḥ na kuppati kasmai avaggāra hattā 	nisinnaḥ hoti kāraka saṅghaḥ sāvajjaḥ kammaṃ pana na kuppati kasmai avaggāra hattā apare pana
vā dvīhi kāraṇehi laddhanāmo ñatti catutthaupasampannabhāvo atidullabhova.	vā dvīhi kāraṇehi laddha nāmaḥ catuttha upasampanna bhāvaḥ 	vā dvīhi kāraṇehi laddha nāmaḥ ñatti catuttha upasampanna bhāvaḥ atidullabha eva
nāma. Brahmapārisajjā, brahmapurohitā, mahābrahmā ca paṭhamajjhānabhūmi idaṃ agginā	nāma brahma pārisajjā brahma purohitā mahābrahmā ca idam agginā 	nāma brahma pārisajjā brahma purohitā mahābrahmā ca paṭhamajjhānabhūmi idam agginā
suddhāvāsā ca catutthajjhānabhūmiceti rūpāvacarabhūmi soḷasavidhā hoti. Avihā, atappā,	suddhāvāsā ca rūpāvacara bhūmi soḷasavidhā hoti avihā a tappā 	suddhāvāsā ca catutthajjhāna bhūmi ceti rūpāvacara bhūmi soḷasavidhā hoti avihā atappā
tasmā manussabhūmito yāva vasavattibhūmi dvesahassānipañcana hutāni duvesatasahassāni	tasmai manussa bhūmitaḥ yāva vasavatti bhūmi hutāni 	tasmā manussa bhūmito yāva vasavatti bhūmi dvesahassāni pañcana hutāni duve sata sahassāni
Tatupari brahmapārisajjādayo tayo brahmuno pañcapaññāsasatasahassa aṭṭhasahassayojane	tad upari brahma pārisajja ādayo tayo brahmuno aṭṭha sahassa yojane 	tad upari brahma pārisajja ādayo tayo brahmuno pañca paññāsa sata sahassa aṭṭha sahassa yojane
Catutthabhūmiyaṃ pana vehapphalaasaññasattā tappamāṇe samatale ṭhāne tiṭṭhanti. Tatuparisuddhāvāsabhūmiyo	catuttha bhūmiyam pana vehapphala asañña sattā tappamāṇe sama tale ṭhāne tiṭṭhanti 	catuttha bhūmiyam pana vehapphala asañña sattā tappamāṇe sama tale ṭhāne tiṭṭhanti tato upari suddhāvāsa bhūmiyo
ca pañcanahutāni ca chasahassāni ca honti tenetaṃ vuccati porāṇehi.	ca cha sahassāni ca honti tena itam vuccati porāṇehi 	ca pañca nahutāni ca cha sahassāni ca honti tena etam vuccati porāṇehi
Dhammāsikoso saṅgho ca, satthusaṅkhyampi gacchatīti.	saṅgho ca satthu saṅkhyam pi gacchati iti 	Dhammā sikoso saṅgho ca satthu saṅkhyam pi gacchati iti
hi ekasmiṃ kāle satasahassādivasena ekato pavattattā te dullabhāpi anacchariyajātattā	hi ekasmin kāle sata sahassa ādi vasena ekatas pavatta tā te dullabhā api 	hi ekasmin kāle sata sahassa ādi vasena ekatas pavatta tā te dullabhā api anacchariya jāta tā
micchāgāhattā brahmūnaṃ āyunā minitepi asamānaṃ saṃvaṭṭasīmāpi viruddhā, tasmā tesaṃ	micchā gāhattā asamānam asamānam viruddhā 	micchā gāhattā brahmūnaṃ āyunā minitepi asamānaṃ saṃvaṭṭasīmāpi viruddhā tasmā tesaṃ
vinassanti. Saṇṭhahantampi ekato saṇṭhahati. Tassa vināsoca saṇṭhahantañca evaṃ veditabbaṃ	vinassanti saṇṭhahantam pi ekatas saṇṭhahati tassa evam veditabbam 	vinassanti saṇṭhahantam pi ekato saṇṭhahati tassa vināso ca saṇṭhahantañ ca evam veditabbam
gokhāyitamattesu jātesu gadrabharavaṃ viravanto ekabindupi na patati. Yadā pacchinnameva	go khāyita mattesu jātesu na patati yadā pacchinnam eva 	go khāyita mattesu jātesu gadrabha ravaṃ viravanto eka bindu pi na patati yadā pacchinnam eva
nāma pāpaṃ natthi, yato saṃsārakhāṇubhāvova nāma hotīti āha “diṭṭhi paramāni bhikkhave	nāma pāpam natthi yatas nāma hoti iti āha diṭṭhi paramāni bhikkhave 	nāma pāpam natthi yato saṃsārakhāṇubhāvova nāma hoti iti āha diṭṭhi paramāni bhikkhave
aṅgulipabbatemanamattampi udakaṃ na saṇṭhāti. Tato dīghassa addhuno accayena chaṭṭho	udakam na saṇṭhāti tatas dīghassa addhunaḥ accayena chaṭṭhaḥ 	aṅgulipabbate manamattampi udakam na saṇṭhāti tato dīghassa addhuno accayena chaṭṭho
mahantaṃ udakarāsiṃ vāto ghanaṃ karotīti ce. Vivarasampadānato taṃ vā tena piṇḍiyamānaṃ	mahantam udaka rāsim vātaḥ ghanam karoti iti tam vā tena piṇḍiyamānam 	mahantam udaka rāsim vāto ghanam karoti iti ce vivarasampadānato tam vā tena piṇḍiyamānam
paranimmitavasavattī, nimmānaratī, tusitā, yāmāti cattāro kāmāvacaradevalokā pātubhavanti.	cattāraḥ kāmāvacara deva lokā pātubhavanti 	paranimmitavasavattī nimmānaratī tusitā yāmā ti cattāro kāmāvacara deva lokā pātubhavanti
iminā brahmūnaṃ āyuparicchedaṃ appatvāva kammakkhayena maraṇaṃ viññāyati. Te honti	iminā āyu paricchedam kamma kkhayena maraṇam viññāyati te honti 	iminā brahmūnaṃ āyu paricchedaṃ appatvāva kamma kkhayena maraṇaṃ viññāyati te honti
hoti te andhakāraṃ disvā bhāyanti. Tato nesaṃ bhayaṃ nāsetvā sūrabhāvaṃ janayantaṃ	te andhakāram disvā bhāyanti tatas bhayam sūra bhāvam janayantam 	hoti te andhakāram disvā bhāyanti tato nesam bhayam nāsetvā sūra bhāvam janayantam
paññāyanti. Anukkamena ca māsaddhamāsautusaṃvaccharā. Candimasūriyānaṃ pana pātubhūtadivaseyeva	paññāyanti anukkamena ca candima sūriyānam pana 	paññāyanti anukkamena ca māsa addhamāsa utu saṃvaccharā candimasūriyānaṃ pana pātubhūta divaseyeva
sinerucakkavāḷahimavantapabbatā pātubhavanti, te ca kho apubbaṃ acarimaṃ phagguṇapuṇṇamadivaseyeva	sineru cakkavāḷa himavanta pabbatā pātubhavanti te ca kho apubbam acarimam 	sineru cakkavāḷa himavanta pabbatā pātubhavanti te ca kho apubbam acarimam phagguṇa puṇṇama divase yeva
āpajjantā sannidhiṃ karonti. Tato pabhuti kaṇopi thusopi taṇḍulaṃ pariyonaddhanti,	āpajjantā sannidhim karonti tatas pabhuti kaṇaḥ upi thusaḥ upi taṇḍulam 	āpajjantā sannidhim karonti tato pabhuti kaṇo upi thuso upi taṇḍulam pariyonaddhanti
Evaṃ candimasūriyapātu bhāvato yāva puna kappavināsakamahāmegho, idaṃ vivaṭṭaṭṭhāyī	evam bhāvataḥ yāva puna kappa vināsaka mahā meghaḥ idam vivaṭṭa ṭṭhāyī 	evam candima sūriya pātu bhāvataḥ yāva puna kappa vināsaka mahā meghaḥ idam vivaṭṭa ṭṭhāyī
ābhassarāti tayopi dutiyajjhānabhūmi udakaṃ gaṇhāti. Tattha tayopi brahmaloke vilīyāpetvā	udakam gaṇhāti tattha tayopi brahmaloke 	ābhassarāti tayopi dutiyajjhānabhūmi udakam gaṇhāti tattha tayopi brahmaloke vilīyāpetvā
yāva kappavināsakaudakaparicchedo saṃvaṭṭo nāma paṭhamamasaṅkhyeyyakappo nāmāti cattāriasaṅkhyeyyakappāni	saṃvaṭṭaḥ nāma paṭhamam asaṅkhyeyya kappaḥ nāma ati cattāri asaṅkhyeyya kappāni 	yāva kappa vināsa kaudaka paricchedo saṃvaṭṭaḥ nāma paṭhamam asaṅkhyeyya kappaḥ nāma ati cattāri asaṅkhyeyya kappāni
eteneva bhūmaṭṭhakavimānāni ākāsaṭṭhakavimānāni ca vināsento chakāmāvacaradevaloke	etena iva bhūma ṭṭhaka vimānāni ākāsa ṭṭhaka vimānāni ca 	etena eva bhūma ṭṭhaka vimānāni ākāsa ṭṭhaka vimānāni ca vināsento cha kāmāvacara devaloke
ābhassarādīsu brahmūnaṃ aṭṭhamahākappādivasena āyu paripuṇṇaṃ siyā, tathā hi paṭhamajjhānatalaṃ	ābhassara ādīsu āyu paripuṇṇam siyā tathā hi paṭhamajjhāna talam 	ābhassara ādīsu brahmūnaṃ aṭṭhamahākappa ādivasena āyu paripuṇṇam siyā tathā hi paṭhamajjhāna talam
Imissā gāthāya “ābhassarāti”ca “subhakiṇhato”ti ca “vehapphalato”ti ca abhividhivasena	imissā gāthāyaḥ ca ca abhividhi vasena 	imissā gāthāya ābhassarāti ca subhakiṇhato ca vehapphalato ca abhividhi vasena
Navabhūmi naṭṭhā vātā, lokanaṭṭhā tadā siyuṃ.	naṭṭhāḥ vātāḥ loka naṭṭhā tadā siyuṃ 	nava bhūmi naṭṭhā vātā loka naṭṭhā tadā siyuṃ
Ābhassaramhi catutthaṃ, parittasubhamhi dve jalaṃ;	catuttham paritta subhamhi dve jalam 	Ābhassaramhi catuttham paritta subhamhi dve jalam
Appamāṇasubhaṃ ekavāraṃ, mataṃ udakasattama”nti.	appamāṇa subham eka vāram matam 	appamāṇa subham eka vāram matam udaka sattama nti
tasmā “ābhassarā”ti ca “subhakiṇhato”ti ca “vehapphalato”ti ca etthābhividhivasena	tasmai ca ca ettha abhividhi vasena 	"tasmā ""ābhassarā"" ti ca ""subhakiṇhato"" ti ca ""vehapphalato"" ti ca ettha abhividhi vasena"
aṅguttaranikāyo parihāyati. Tasmimpi paṭhamaṃ ekādasanipāto…pe… tato ekanipātoti	aṅguttara nikāyo tasmin pi paṭhamam ekādasa nipāta upe tatas eka nipāta uti 	aṅguttara nikāyo parihāyati tasmin pi paṭhamam ekādasa nipāta pe tato eka nipāta iti
pavattati, tāva pariyatti anantarahitāva hoti. Yadā saddho pasanno rājā hatthikkhandhe	pavattati tāva hoti yadā saddhaḥ pasannaḥ rājā hatthikkhandhe 	pavattati tāva pariyatti anantarahitāva hoti yadā saddho pasanno rājā hatthikkhandhe
carāpite na suṇantāpi honti asuṇantāpi, yāva tatiyaṃ carāpetvā gaṇhakaṃ alabhitvā	na suṇantā api honti a suṇantā api yāva tatiyam gaṇhakam a labhitvā 	carāpite na suṇantā api honti a suṇantā api yāva tatiyaṃ carāpetvā gaṇhakaṃ a labhitvā
“mayhaṃ evarūpaṃ rajjaṃ kiṃ vilāsaṃ rajjānubhāvaṃ saddhammaviyogena, divākaravirahito	evarūpam vilāsam rajja anubhāvam saddhamma viyogena divākara virahitaḥ 	mayham evarūpam rajjam kim vilāsam rajja anubhāvam saddhamma viyogena divākara virahitaḥ
kāmesumicchācāro sūkariko orabbhiko sākuṇi ko coro paradāriko taṃ gahetvā sīsacchinnānaṃ	kāmesum icchā ācāraḥ sūkarikaḥ orabbhikaḥ sākuṇikaḥ coraḥ paradārikaḥ tam gahetvā 	kāmesu micchā cāro sūkariko orabbhiko sākuṇiko coro paradāriko taṃ gahetvā sīsacchinnānaṃ
issāmacchariyamāyāsāṭheyyathambhasārambhamānāti mānamadapamādataṇhā’vijjātividhākusalamūladuccaritasaṃkilesamalavisamasaññāvitakka	māna mada apamāda taṇhā vid jāti vidhā kusala mūla duccarita saṃkilesa mala visama saññā vitakka 	issā macchariya māyā sāṭheyya thambha sārambha mānāti māna mada apamāda taṇhā avijjā tividhā akusala mūla duccarita saṃkilesa mala visama saññā vitakka
papañcacatubbidhavipariyesaāsavaganthaoghayogā’gatiganthu’ pādānapañcacetokhilavinibandhanīvaraṇā’bhinandana	pā dāna pañca cetaḥ khila vinibandhanī varaṇa abhinandana 	papañca catubbidha vipariyesa āsava gantha ogha yoga agati ganthu pādāna pañca cetaḥ khila vinibandhanī varaṇa abhinandana
chavivādamūlataṇhākāyasattānusaya aṭṭhamicchattanavataṇhāmūlakadasākusalakammapatha	cha vivāda mūla taṇhā kāya satta anusaya 	cha vivāda mūla taṇhā kāya satta anusaya aṭṭha micchatta nava taṇhā mūlaka dasa akusala kammapatha
dvāsaṭṭhidiṭṭhigata aṭṭhasatataṇhāvicaritappa bheda sabbadarathapariḷāhakilesasatasahassāni,	aṭṭha sata taṇhā vicarita ppa bheda 	dvāsaṭṭhi diṭṭhi gata aṭṭha sata taṇhā vicarita ppa bheda sabba daratha pariḷāha kilesa sata sahassāni
Kappeca satasahasse, caturo ca asaṅkhyeyye.	sata sahasse caturaḥ ca asaṅkhyeyye 	Kappe ca sata sahasse caturo ca asaṅkhyeyye
āgamatopi gatinimittameva yujjati tathā hi tusitapureyeva setaketudevaputto hutvā	āgamataḥ api gati nimittam eva yujjati tathā hi setaketu deva puttaḥ hutvā 	āgamataḥ api gati nimittam eva yujjati tathā hi tusita pure eva setaketu deva puttaḥ hutvā
teneva abhidhammatthasaṅgahādīsu abhidhammattha vibhāvaniyaṃ “maraṇakāle yathārahaṃ	tena iva abhidhamma attha saṅgaha ādīsu maraṇa kāle yathāraham 	tena eva abhidhamma attha saṅgaha ādīsu abhidhammattha vibhāvaniyaṃ maraṇa kāle yathārahaṃ
vā kammabalena channaṃ dvārānamaññatarasmiṃ paccupaṭṭhāsi, tato paraṃ tameva tathopaṭṭhitamālambaṇaṃ	vā kamma balena channam tato param tam eva tathā upaṭṭhitam ālambaṇam 	vā kamma balena channam dvārānam aññatarasmiṃ paccupaṭṭhāsi tato param tam eva tathā upaṭṭhitam ālambaṇam
patiṭṭhāti bhavantare”ti vuttaṃ. Tattha “tatthoṇataṃva cittasantānamabhiṇhaṃ pavattati	patiṭṭhāti bhavantare iti vuttam citta santānam abhiṇham pavattati 	patiṭṭhāti bhavantare iti vuttaṃ tattha tatthoṇataṃva citta santānam abhiṇhaṃ pavattati
Ubhopi rathe ṭhatvā sabbe olokentānaṃyeva tusitapuraṃ agamaṃsu. Imasmiñhi vatthusmiṃ	ubho api rathe ṭhatvā sabbe tusitapuram agamaṃsu imasmin hi vatthusmin 	ubho api rathe ṭhatvā sabbe olokentānaṃ yeva tusitapuram agamaṃsu imasmin hi vatthusmin
Rājā tassa mahallakoti vatvā aññassa coraghātaka kammaṃ dāpesi. So coraghātakakammā	rājā tassa mahallakaḥ iti vatvā aññassa kammam dāpesi saḥ cora ghātaka kammā 	rājā tassa mahallakaḥ iti vatvā aññassa cora ghātaka kammam dāpesi saḥ cora ghātaka kammā
Yo karoti samaṃ pūjaṃ, phalaṃ tāsa samaṃ siyā’ti.	yaḥ karoti samam pūjam phalam samam siyāti 	yo karoti samam pūjam phalam tāsa samam siyāti
ekaṃ, arahattamaggaṭṭho phalaṭṭhoti ekanti cattāri purisayugāni honti. Cattāro maggaṭṭhā	ekam phala ṭṭho ti ekam ti cattāri purisa yugāni honti cattāraḥ magga ṭṭhā 	ekaṃ arahatta magga ṭṭho phala ṭṭho ti ekaṃ ti cattāri purisa yugāni honti cattāro magga ṭṭhā
Vuccatepādakajjhānasammasitajjhānapuggalajjhāsayesupi hi aññataravasena taṃ taṃ jhānasadisavitakkādiaṅgapātubhāvena	hi aññatara vasena tam tam jhāna sadisa vitakka ādi aṅga pātubhāvena 	Vuccate pādaka jhāna sammasita jhāna puggala ajjhāsayesu pi hi aññatara vasena tam tam jhāna sadisa vitakka ādi aṅga pātubhāvena
sattakkhattuparamoti tayo sotāpannā. Kāmarūpārūpabhavesu adhigataphalā tayo sakadāgāminoti	tayo sā utāpannā kāmarūpa arūpa bhavesu adhigata phalā tayo sakadāgāmino ti 	sattakkhattuparamoti tayo sotāpannā kāmarūpa arūpa bhavesu adhigata phalā tayo sakadāgāmino ti
uddhaṃsoto akaniṭṭhagāmīti avihāsu pañca anāmigāno, tathā atappāsudassāsudassīsupi	a kaniṭṭha gāmī iti a vihāsu pañca tathā 	uddhaṃ soto a kaniṭṭha gāmī iti a vihāsu pañca anāgāmino tathā atappāsu sudassāsu sudassīsu pi
sattakkhattuparamaṃ vadanti. Taṃ ayuttaṃ kasmā “kiñcāpi te honti bhusaṃpamattā, na	satta kkhattu paramam vadanti tam ayuttam kasmā kiñca api te honti na 	satta kkhattu paramam vadanti tam ayuttam kasmā kiñca api te honti bhusam pamattā na
te bhavaṃ aṭṭhamamādiyantī”ti pāḷiyā virodhattā. Apica dvibhavaparicchinno sakadāgāmīpi	te bhavam aṭṭhamam ādiyanti iti apica dvi bhava paricchinnaḥ 	te bhavam aṭṭhamam ādiyanti iti pāḷiyā virodhattā apica dvi bhava paricchinno sakadāgāmīpi
ayaṃ jīvitasamasīsīnāma. Tattha terasa sīsāni katamāni terasa sīsāni. Palibodhasīsaṃ,	ayam tattha terasa sīsāni katamāni terasa sīsāni palibodha sīsam 	ayam jīvitasamasīsīnāma tattha terasa sīsāni katamāni terasa sīsāni palibodha sīsam
Evañca sati “mandappavattiyaṃ pana maraṇakālādīsu pañcavāramevā”ti ettha “mandappavattiya”nti	evam ca sati pana maraṇa kāla ādīsu pañca vāram eva ati ettha manda ppavattiyan ti 	"evam ca sati ""manda ppavattiyam pana maraṇa kāla ādīsu pañca vāram eva"" ti ettha ""manda ppavattiyan"" ti"
nivatteti. Asammūḷhakāle pana chasattakkhattumpi anujānāti. Kāmāvacarajavanānañca	nivatteti a sammūḍha kāle pana cha satta kkhattum pi anujānāti 	nivatteti a sammūḷha kāle pana cha satta kkhattum pi anujānāti kāmāvacara javanānaṃ ca
aniyataparimāṇā balavakālepi parisampuṇṇabhāvā tathā hi “kāmāvacarajavanānibalavakāle	aniyata parimāṇā balava kāle api parisampuṇṇa bhāvā tathā hi 	aniyata parimāṇā balava kāle api parisampuṇṇa bhāvā tathā hi kāmāvacara javanāni balava kāle
Bhagavato yamakapāṭihāriyakālādīsu lahukappavattiyaṃ cattāri pañcavā paccavekkhaṇajavanacittāni	bhagavataḥ yamaka pāṭihāriya kāla ādīsu cattāri paccavekkhaṇa javana cittāni 	bhagavato yamaka pāṭihāriya kāla ādīsu lahu kappa vattiyaṃ cattāri pañca vā paccavekkhaṇa javana cittāni
maraṇāsannavīthicittassa visuṃ alabbhanato paccavekkhaṇanteyeva bhavaṅgacittena parinibbānato	maraṇa āsanna vīthi cittassa visum a labbhanato bhavaṅga cittena parinibbānato 	maraṇa āsanna vīthi cittassa visum a labbhanato paccavekkhaṇa ante yeva bhavaṅga cittena parinibbānato
Na so saṅkhatadhammānaṃ, kalaṃ nāgghati soḷasi”nti.	na saḥ saṅkhata dhammānam kalam na agghati 	na so saṅkhata dhammānaṃ kalaṃ na agghati soḷasiṃ
aggamakkhāyati. Kasmā yasmā agārikaratanesu aggo cakkavattīpi sīlādiguṇayuttaṃ anagārikaratanaṃ	aggam akkhāyati kasmai yasmai agārika ratanesu aggaḥ sīla ādi guṇa yuttam anagārika ratanam 	aggam akkhāyati kasmā yasmā agārika ratanesu aggo cakkavattīpi sīla ādi guṇa yuttam anagārika ratanam
Samathayānikaratanampi duvidhaṃ sāvakapāramippattamapattañca. Tattha sāvakapāramippattaṃ	duvidham sāvaka pāramippattam apattam ca tattha sāvaka pāramippattam 	samatha yānika ratanam pi duvidham sāvaka pāramippattam apattam ca tattha sāvaka pāramippattam
sāriputtamoggalānādayo ariyapuggalā vā. Tepi alabhantena ekantajahitaṃ sivaṭṭhikaṃ	ariya puggalāḥ vā te pi a labhantena ekanta jahitam sivaṭṭhikam 	sāriputta moggalāna ādayo ariya puggalā vā te pi a labhantena ekanta jahitaṃ sivaṭṭhikaṃ
buddhapaccekabuddhā asīti ca mahāsāvakā aññe ca tathāgatassa sāvakā sunettamahāgovindavidhurasarabhaṅgamahosadhasutasomanimirājaayogharakumāraka	buddha paccekabuddhāḥ asi iti ca mahāsāvakāḥ aññe ca tathāgatassa sāvakā 	buddha paccekabuddhā asīti ca mahāsāvakā aññe ca tathāgatassa sāvakā sunetta mahāgovinda vidhura sarabhaṅga mahosadha sutasoma nimirāja ayoghara kumāraka
Pattāpi surabhi vāyanti, evaṃ dhīrūpasevanā”ti.	surabhi vāyanti evam dhī rūpa sevanā ati 	Pattā pi surabhi vāyanti evam dhī rūpa sevanā ti
Apica tepi sappurise saṅgamma assutapubbampi ubhayalokahitāvahaṃ vācaṃ suyyateva, vuttampi cetaṃ.	apica te pi sappurise saṅgamma a ssuta pubbam pi ubhaya loka hita āvaham vācam 	apica te pi sappurise saṅgamma a ssuta pubbam pi ubhaya loka hita āvaham vācam suyyati eva vuttam pi etam
Evamādippabhedā sappurisā loke atidullabhāva. Tabbigamena duppurisā bālajanā agavesantopi	evamādi ppabhedā sappurisāḥ loke tad vigamena duppurisāḥ bāla janāḥ 	evamādi ppabhedā sappurisāḥ loke atidullabhāva tad vigamena duppurisāḥ bāla janāḥ agavesantopi
labbhanteva te bālā attānaṃ sevamāne parajane saṃsāradukkheyeva osīdenti bhavato	labbhanta iva te bālāḥ attānam sevamāne para jane osīdenti bhavato 	labbhanta iva te bālāḥ attānam sevamāne para jane saṃsāradukkhe eva osīdenti bhavato
Tattha vassagaṇanāpi evaṃ veditabbā yathāha “sataṃsatasahassāni koṭi hoti evaṃ sataṃsahassakoṭiyo	tattha vassa gaṇanā api evam veditabbā yathā āha evam evam 	tattha vassa gaṇanā api evam veditabbā yathā āha satam sata sahassāni koṭi hoti evam satam sahassa koṭiyo
imāni nāmāni laddhānīti vadanti. Aparepi vānakāraṇehīti ṭīkānetti. Yathā ca dīghavidassaāghātā	imāni nāmāni laddhāni iti vadanti apare pi yathā ca 	imāni nāmāni laddhāni iti vadanti apare pi vānakāraṇehi iti ṭīkānetti yathā ca dīghavidassa āghātā
Akattipaṇḍitocāpi sakkena devānamindena vare diyyamāne evamāha	sakkena devānamindena vare diyyamāne evam āha 	akatti paṇḍito cāpi sakkena devānamindena vare diyyamāne evam āha
bhinditvā gaṅgāyaṃ khipi tena gaṅgānadiyā vāhena eko uddhaṃ eko heṭṭhāti evaṃ dve	bhinditvā tena gaṅgā nadiyā vāhena ekaḥ uddham ekaḥ heṭṭhā ati evam dve 	bhinditvā gaṅgāyaṃ khipi tena gaṅgā nadiyā vāhena eko uddhaṃ eko heṭṭhā iti evaṃ dve
evameva manussattabhāvopi dullabhoyeva tathāhi manussattabhāvaṃ alabhitvāva nirayapetaasurakāyatiracchānabhūmīsuyeva	evam eva manussatta bhāvaḥ api dullabhaḥ yeva tathā hi manussatta bhāvam a labhitvā ava 	evam eva manussatta bhāvo api dullabho yeva tathā hi manussatta bhāvam a labhitvā eva niraya peta asura kāya tiracchāna bhūmīsu yeva
catupañcachasattaaṭṭhakalabhāgamatteneva aṅguliyā patiṭṭhitaṭṭhānamatteyeva bhūmipadese	catu pañca cha satta aṭṭha kala bhāga mattena iva aṅguliyā bhūmi padese 	catu pañca cha satta aṭṭha kala bhāga mattena eva aṅguliyā patiṭṭhita ṭhāna mattena eva bhūmi padese
paccantavisaya arūpaasaññasattatiracchānapetanerayikakāle vā majjhimadesepi cakkhādiaṅgavikalevā	arūpa asañña satta tiracchāna peta nerayika kāle vā majjhima dese pi cakkha ādi aṅga vikale vā 	paccanta visaya arūpa asañña satta tiracchāna peta nerayika kāle vā majjhima dese pi cakkha ādi aṅga vikale vā
hi pavattā janā pāṇātipātādidasaakusalakammapatheyeva ramanti abhiramanti, caṇḍasabhāvā	hi pavattā janā ramanti abhiramanti caṇḍa sabhāvā 	hi pavattā janā pāṇātipātādi dasa akusala kamma pathe yeva ramanti abhiramanti caṇḍa sabhāvā
ca te honti, ratanattayaguṇampi na jānanti. Arūpinopi puggalā paratoghosavirahitattā	ca te honti na jānanti arūpinaḥ pi puggalā 	ca te honti, ratanattayaguṇampi na jānanti. Arūpinopi puggalā paratoghosavirahitattā
tipiṭakadharena’saddhammakovido’ti pākaṭa nāmadheyyena mahātherena upajjhāyo hutvā	pākaṭa nāmadheyyena mahā therena upajjhāyaḥ hutvā 	tipiṭakadharena saddhammakovido ti pākaṭa nāmadheyyena mahā therena upajjhāyaḥ hutvā
