original	analyzed	corrected
Vattabbameva ca bahumpi yato na vuttaṃ	vattabbam eva ca yatas na vuttam 	vattabbam eva ca bahum pi yato na vuttam
vacanato thūpārahānaṃ buddhādīnaṃ dhātuyo patiṭṭhāpetvā kata cetiyaṃ abbhunana taṭṭhena	vacanataḥ buddha ādīnam dhātuyaḥ patiṭṭhāpetvā kata cetiyam 	vacanato thūpārahānaṃ buddha ādīnaṃ dhātuyo patiṭṭhāpetvā kata cetiyaṃ abbhunana taṭṭhena
katoti ce? Yodīpaṅkarādīnaṃ catuvīsatiyā buddhānaṃ santike laddhavyākaraṇo samatiṃsapāramiyo	catuvīsatiyā buddhānam santike laddha vyākaraṇaḥ 	kato ti ce yo dīpaṅkara ādīnaṃ catuvīsatiyā buddhānaṃ santike laddha vyākaraṇo samatiṃsa pāramiyo
jayasumana kusuma sadisi vaṇṇaṃ dupaṭṭacīvaraṃ timaṇḍalaṃ paṭicchādetvā nivāsetvā	du paṭṭa cīvaram ti maṇḍalam paṭicchādetvā nivāsetvā 	jayasumana kusuma sadisi vaṇṇaṃ du paṭṭa cīvaraṃ ti maṇḍalaṃ paṭicchādetvā nivāsetvā
rattavara pasukūla cīvaraṃ pāripitvā gaṇdhakūgidva rato kanakaguhāto sīho viya nikkhamitvā	cīvaram pāripitvā rataḥ kanakaguhāto sīhaḥ viya nikkhamitvā 	rattavara pasukūla cīvaraṃ pāripitvā gaṇdhakūgidva rataḥ kanakaguhāto sīhaḥ viya nikkhamitvā
jaḷabhiññānaṃyeva catūhi khīṇāsava satasahassehi parivuto amaragaṇa parivuto dasasatanayano	catūhi khīṇāsava sata sahassehi parivutaḥ amara gaṇa parivutaḥ dasa sata nayanaḥ 	jaḷabhiññānaṃyeva catūhi khīṇāsava sata sahassehi parivuto amara gaṇa parivuto dasa sata nayano
dvattiṃsa varalakkhaṇa patimaṇḍitaṃ asatiyā anubyañjanehi anubyañjitaṃ byāmappahāparikkhepa	asatiyā anubyañjanehi anubyañjitam byāma ppahā parikkhepa 	dvattiṃsa vara lakkhaṇa patimaṇḍitaṃ asatiyā anubyañjanehi anubyañjitaṃ byāma ppahā parikkhepa
sassīrīkaṃ iṇdanīlamaṇisaṃkāsoākāse nānappakārā vijjullatā viya chabbaṇṇabuddharaṃsiyo	nānappakārāḥ vijjullatāḥ viya chabbaṇṇa buddha raṃsiyaḥ 	sassīrīkaṃ iṇdanīlamaṇisaṃkāsa ākāse nānappakārā vijjullatā viya chabbaṇṇa buddha raṃsiyo
Ussīsake maṃ ṭhatvāna - idaṃ vacanamabravi;	ussīsake mam idam vacanam abravi 	ussīsake mam ṭhatvāna idam vacanam abravi
Ahu kapilavahayā rammā - nikkhamitvā tathāgato. Padhānaṃ padahitvāna - katvā dukkara kārikaṃ	ahu kapilavahayā rammā  katvā dukkara kārikam 	ahu kapilavahayā rammā nikkhamitvā tathāgato padhānaṃ padahitvāna katvā dukkara kārikaṃ
pallaṅkaṃ ābhujitvā nisinno buddhakārakadhamme upadhārento kahananu kho buddhakāraka	pallaṅkam ābhujitvā nisinnaḥ buddha kāraka dhamme upadhārento 	pallaṅkam ābhujitvā nisinnaḥ buddha kāraka dhamme upadhārento kaha nu kho buddha kāraka
- mettā - upekkhā pāramiyoca disvā tatthadaḷha samādānaṃ katvā devatāhi abhitthuto	mettā upekkhā pāramiyo ca disvā samādānam katvā devatāhi 	mettā upekkhā pāramiyo ca disvā tattha daḷha samādānam katvā devatāhi abhitthuto
Tattheva tassa jinathūpo - chattiṃsubbedha yojano“;	tattha iva tassa jina thūpaḥ yojanaḥ 	tattha eva tassa jina thūpaḥ chattiṃsu ubbedha yojanaḥ
“Sumano yasadharo - buddho aggārāmamha nibbuto,	sumanaḥ yasadharaḥ buddhaḥ nibbutaḥ 	sumanaḥ yasadharaḥ buddhaḥ aggārāmamha nibbutaḥ
“Revato pavaro buddho - nibbuto so mahāpure,	revataḥ pavaraḥ buddhaḥ nibbutaḥ saḥ mahā pure 	revataḥ pavaraḥ buddhaḥ nibbutaḥ saḥ mahā pure
Dhātu vitthārikaṃ āsī - tesu tesu padesato”ti;	dhātu vitthārikam āsi tesu tesu 	dhātu vitthārikam āsi tesu tesu padesato ti
Dhātu vitthārikaṃ āsi - tesu tesu padesato”ti;	dhātu vitthārikam āsi tesu tesu 	dhātu vitthārikam āsi tesu tesu padesato ti
pañcasu abhiññāsu aṭṭhasuca samāpattisuciṇṇavasī hutvā buddhapamukhassa saṅghassa	pañcasu abhiññāsu hutvā buddha pamukhassa saṅghassa 	pañcasu abhiññāsu aṭṭhasu ca samāpattisu ciṇṇavasī hutvā buddha pamukhassa saṅghassa
sataccayena buddho bhavissatīti vyākāsi piyadassissa bhagavatopi dhātuyo ekaghanāva	buddhaḥ bhavissati iti piyadassissa bhagavataḥ api 	sataccayena buddhaḥ bhavissati iti vyākāsi piyadassissa bhagavataḥ api dhātuyo ekaghanā va
vassetvā samantato pupphamaṇḍapa pupphaagaghiya toraṇādīni katvā maṇdārava pupphacchattena	vassetvā samantataḥ toraṇa ādīni katvā maṇdārava puppha chattena 	vassetvā samantato pupphamaṇḍapa pupphaagaghiya toraṇa ādīni katvā maṇdārava puppha chattena
vyākāsi. Dhammadassissa pana bhagavato dhātuyo ekaghanā ahesuṃ. Jambudīpavāsino tiyojanikaṃ thūpamakaṃsu.	dhammadassissa pana bhagavataḥ dhātuyaḥ eka ghanāḥ ahesum jambudīpa vāsinaḥ ti yojanikam 	vyākāsi dhammadassissa pana bhagavato dhātuyo eka ghanā ahesuṃ jambudīpa vāsino ti yojanikaṃ thūpamakaṃsu
bhavissatīti vyākāsi. Tassāpi bhagavato dhātuyo na vikiriṃsu dhātuyo gahetvā tiyojanikaṃ thūpamakaṃsu.	bhavissati iti tassa api bhagavataḥ dhātuyaḥ na vikiriṃsu dhātuyaḥ gahetvā ti yojanikam 	bhavissati iti vyākāsi tassa api bhagavato dhātuyaḥ na vikiriṃsu dhātuyaḥ gahetvā ti yojanikam thūpam akaṃsu
Tattheva tassa thūpavaro-tīṇi yojanamussito”ti;	tattha iva tassa thūpa varā utīṇi 	tattha eva tassa thūpa varo tīṇi yojana mussito ti
Dhātuvitthārikaṃ āsi-tesu tesu padesato”ti;	dhātu vitthārikam āsitesu tesu 	dhātu vitthārikam āsi tesu tesu padesato ti
dhātuyo gahetvā tiyojanubbedhaṃ sattaratanamayaṃ himagiri sadisa sobhaṃ thūpamakaṃsu.	dhātuyaḥ gahetvā ti yojana ubbedham satta ratana mayam himagiri sobham 	dhātuyo gahetvā ti yojana ubbedhaṃ satta ratana mayaṃ himagiri sadisa sobhaṃ thūpamakaṃsu
Dhātuvitthārikaṃ āsi-tesu tesu padesato”ti;	dhātu vitthārikam āsitesu tesu 	dhātu vitthārikam āsi tesu tesu padesato ti
Dhātu vitthārikaṃ āsi-tesu tesu padesato”ti;	dhātu vitthārikam āsitesu tesu 	dhātu vitthārikam āsi tesu tesu padesato ti
buddhasāsanaṃ sobhesi. Sopi naṃ satthā vyākāsi. Kassapassa pana satthuno dhātuyo	buddha sāsanam sobhesi saḥ api nam satthā kassapassa pana satthuno 	buddha sāsanam sobhesi saḥ api nam satthā vyākāsi kassapassa pana satthuno dhātuyo
agghanakaṃ ratanavicittaṃ bahi racanatthaṃ ekekaṃ aḍḍhakoṭi agghanakaṃ abbhantara	agghanakam ratana vicittam bahi racana attham ekekam agghanakam 	agghanakam ratana vicittam bahi racana attham ekekam addha koti agghanakam abbhantara
Thupappamāṇametesaṃ pāliyaṃyeva dassitaṃ;	thupa pappamāṇam etesam dassitam 	thupa pappamāṇam etesam pāliyam yeva dassitam
Dhātu vitthārikā āsuṃ - tesu tesu padesatoti;	dhātu vitthārikāḥ āsuṃ tesu tesu 	dhātu vitthārikā āsuṃ tesu tesu padesato ti
Sāpi dānabalo mayhaṃ-sattakkattuṃ pakampathā”ti;	sā api dāna balaḥ pakampatha ati 	sā api dāna balo mayhaṃ sattakkattuṃ pakampatha iti
milāyanti, kacchehi sedā muccanti, kāyeceva dubbaṇṇiyaṃ okkamati. Devo devāsane nābhiramatīti	milāyanti kacchehi sedāḥ muccanti okkamati devaḥ devāsane na abhiramati iti 	milāyanti kacchehi sedāḥ muccanti kāye ca eva dubbaṇṇiyaṃ okkamati devaḥ devāsane na abhiramati iti
“Yatohaṃ tusite kāye-santusito nāmahaṃ tadā,	yatas ham tusite nāma aham tadā 	yato aham tusite kāye santusito nāma aham tadā
gamanasamaye anukkamena jiṇṇa - vyādhi - matasaṅkhāte tayo devadūte disvā saṃjāta	gamana samaye anukkamena deva dūte disvā saṃjāta 	gamana samaye anukkamena jiṇṇa vyādhi mata saṅkhāte tayo deva dūte disvā saṃjāta
atikkamma anomāya nadiyā paratīraṃ patvā assāpiṭṭhito oruyha muttarāsi sadise cālikāpuliṇe	atikkamma anomāya nadiyāḥ para tīram patvā oruyha sadise ca alikā puliṇe 	atikkamma anomāya nadiyā paratīraṃ patvā assāpiṭṭhito oruyha muttarāsi sadise ca alikā puliṇe
ṭhatvā channatvaṃ mayhaṃ ābharaṇāni ceva kaṇthakañca ādāya gacchāhi ābharaṇāni ca	ābharaṇāni ca iva kaṇthakam ca ādāya gacchāhi ābharaṇāni ca 	ṭhatvā channatvaṃ mayhaṃ ābharaṇāni ceva kaṇthakam ca ādāya gacchāhi ābharaṇāni ca
Tasmā tamma mahābodhi-sattānaṃ paṭipattiyaṃ,	mahā bodhisattānam paṭipattiyam 	Tasmā tamma mahā bodhisattānam paṭipattiyam
patvā tissavijitaṃ āgamanatthāyatenagahita paṭiñño āḷāraṃ-uddakañca upasaṅkamitvā	patvā tissavijitam paṭiññaḥ āḷāram uddakam ca upasaṅkamitvā 	patvā tissavijitam āgamanatthāya tena gahita paṭiññaḥ āḷāram uddakam ca upasaṅkamitvā
majjhimayāme cutūpapātañāṇaṃ patvā pacchimayāmāvasāne dasabala catuvesārajjādi sabbaguṇapatimaṇḍitaṃsabbaññutañāṇaṃ	majjhima yāme cutūpapāta ñāṇam patvā pacchima yāma avasāne sabba guṇa patimaṇḍita sabbaññuta ñāṇam 	majjhima yāme cutūpapāta ñāṇam patvā pacchima yāma avasāne dasabala catuvesārajjādi sabba guṇa patimaṇḍita sabbaññuta ñāṇam
pañcavaṇṇa padumasañchanno ahosi tiyojana sahassavitthato pana himavā ghanabaddhamorapiñchakalāpo	paduma sañchannaḥ ahosi sahassa vitthataḥ pana himavā ghana baddha mora piñcha kalāpaḥ 	pañca vaṇṇa paduma sañchannaḥ ahosi ti yojana sahassa vitthataḥ pana himavā ghana baddha mora piñcha kalāpaḥ
Yamakasālā bhummadevatāni sañcālitakkhaviṇdhaṭapā tathāgatasarīrassa uparipupphāni	yamaka sālā bhumma devatāni tathāgata sarīrassa upari pupphāni 	yamaka sālā bhumma devatāni sañcālitakkhaviṇdhaṭapā tathāgata sarīrassa upari pupphāni
kāḷānusārī tagara lohitacaṇdanādi sabbagaṇdhajātacuṇṇāni, haritālañjana suvaṇṇa rajata	tagara lohita caṇdana ādi sabba gaṇdha jāta cuṇṇāni 	kāḷānusārī tagara lohita caṇdana ādi sabba gaṇdha jāta cuṇṇāni haritāla añjana suvaṇṇa rajata
cuṇṇāni, sabbagaṇdhavāsa vikatiyo suvaṇṇa rajatādisamugge pūretvā cakkavāḷa mukhavaṭṭiādisu	cuṇṇāni suvaṇṇa rajata ādi samugge pūretvā 	cuṇṇāni sabbagaṇdhavāsa vikatiyo suvaṇṇa rajata ādi samugge pūretvā cakkavāḷa mukhavaṭṭi ādisu
turiyāni antalikkhe vajjanti. Na kevalañca tāniyeva sabbānipi tantibaddha cammapariyonaddha	turiyāni antalikkhe vajjanti na kevalam ca tāniyā iva sabbāni pi 	turiyāni antalikkhe vajjanti na kevalam ca tāniyeva sabbāni pi tantibaddha cammapariyonaddha
Tena kho pana samayena kusinārā yāva saṇdhisamala saṃkaṭīrājannumattena odhinā maṇdārava	tena khalu pana samayena kusinārāḥ odhinā maṇdārava 	tena kho pana samayena kusinārā yāva saṇdhisamala saṃkaṭīrājannumattena odhinā maṇdārava
gahetvā tālavaṇeṭahi vijantā bhastāni dhamantā na sakkontiyeva aggiṃ gāhāpetuṃ. Atha	gahetvā vijantāḥ bhastāni dhamantāḥ na aggim gāhāpetum atha 	gahetvā tālavaṇeṭahi vijantā bhastāni dhamantā na sakkontiyeva aggiṃ gāhāpetuṃ atha
arasahassa patimaṇḍitā dasabalassa pādā saddhiṃ kappāsa paṭalehi pañcadussayugasatāni	dasabalassa pādā saddhim kappāsa paṭalehi 	arasa hassa patimaṇḍitā dasabalassa pādā saddhiṃ kappāsa paṭalehi pañca dussa yuga satāni
uṇhīsanti imā sattadhātuyo na vippakiṇṇā. Sesā vippakiriṃsu. Tattha sabbakhuddakā	imāḥ satta dhātuyaḥ na vippakiṇṇā sesāḥ tattha sabba khuddakā 	uṇhīsanti imāḥ satta dhātuyaḥ na vippakiṇṇā sesāḥ vippakiriṃsu tattha sabba khuddakā
citakameva gaṇhi mallarājāno ca suvaṇṇaghaṭe rajataghaṭe ca pūretvā ābhata nānāgaṇdhodakena	citakam eva ca suvaṇṇa ghaṭe rajata ghaṭe ca pūretvā nānā gaṇdha udakena 	citakam eva gaṇhi mallarājāno ca suvaṇṇa ghaṭe rajata ghaṭe ca pūretvā ābhata nānā gaṇdha udakena
jhayamāne parivāretvā ṭhita sālarukkhānaṃ sākhantarehi viṭapantarehi pattantarehi	sāla rukkhānam sākha antarehi viṭapa antarehi patta antarehi 	jhāyamāne parivāretvā ṭhita sāla rukkhānam sākha antarehi viṭapa antarehi patta antarehi
Bhagavāpi khattiyo, ahampi khattiyo, ahampi arahāmi bhagavato sarīrānaṃ thūpañca	bhagavā api khattiyaḥ aham pi khattiyaḥ aham pi arahāmi bhagavato 	bhagavā api khattiyaḥ aham pi khattiyaḥ aham pi arahāmi bhagavato sarīrānaṃ thūpañca
kāreṃntāva pacchato jātā. Te sabbepi sattanagaravāsino āgattvā amhākaṃ dhātuyo vā	pacchatas jātā te sabbe api satta nagara vāsinaḥ āgattvā amhākam dhātuyaḥ vā 	kāreṃntāva pacchatas jātā te sabbe api satta nagara vāsinaḥ āgattvā amhākam dhātuyaḥ vā
mātu thanato khiraṃ pītaṃ, amhehipi pītaṃ tumheyeva purisā amhe na purisā hotu hotūti	khiram pītam amhehi pi pītam tumheya iva purisāḥ amhe na purisāḥ hotu hotu uti 	mātu thanato khiram pītam amhehi pi pītam tumheya eva purisā amhe na purisā hotu hotu iti
ekapadampi te na jāniṃsu dutiyaka bhāṇavāra pariyosāne’ācariyassa viya bhosaddo,	eka padam pi te na jāniṃsu viya bhosaddaḥ 	eka padam pi te na jāniṃsu dutiyaka bhāṇavāra pariyosāne ācariyassa viya bhosaddaḥ
khattiyo, mayampi khattiyo mayampi, arahāma labhituṃ bhagavato sarīrānaṃ bhāganti	khattiyaḥ mayam pi khattiyaḥ mayam pi arahāma labhitum bhagavato 	khattiyaḥ mayam pi khattiyaḥ mayam pi arahāma labhitum bhagavato sarīrānam bhāganti
attano attano balānurūpena nīharitvā sakasakaṭṭhāne thūpamakaṃsu. Doṇipi brāhmaṇo	attanaḥ attanaḥ bala anurūpena nīharitvā saka saka ṭṭhāne brāhmaṇo 	attanaḥ attanaḥ bala anurūpena nīharitvā saka saka ṭṭhāne thūpam akaṃsu doṇi pi brāhmaṇo
piphphalīvaniyāpi moriyā sakasakaṭṭhāne thūpamakaṃsūti.	piphphalī vaniyā api moriyā saka saka ṭṭhāne 	piphphalī vaniyā api moriyā saka saka ṭṭhāne thūpam akaṃsu iti
tāva mama hotu, dhātuyo pana kathaṃ āharāpemiti. Na mahārāja dhātu āharaṇaṃ tuyhaṃ	mama hotu na mahā rāja dhātu āharaṇam 	tāva mama hotu dhātuyo pana kathaṃ āharāpemiti na mahā rāja dhātu āharaṇaṃ tuyhaṃ
thūpe kāreti idha rājā kiṃ kārehīti pucchantānampi mahāsāvakānaṃcetiyā nīti vadanti	thūpe kāreti idha rājā kim vadanti 	thūpe kāreti idha rājā kiṃ kārehīti pucchantānampi mahāsāvakānaṃ cetiyā nīti vadanti
kāresi pañcapañcasate suvaṇṇarajatamaye puṇṇaghaṭe ṭhapāpesi pañcasuvaṇṇadhajasate	pañca pañca sate suvaṇṇa rajata maye puṇṇa ghaṭe pañca suvaṇṇa dhaja sate 	kāresi pañca pañca sate suvaṇṇa rajata maye puṇṇa ghaṭe ṭhapāpesi pañca suvaṇṇa dhaja sate
pidahitvā āviñjana rajjuyaṃ kuñcikamuddikaṃ baṇdhi tattheva mahantaṃ maṇikkhaṇdhaṃ	pidahitvā kuñcika muddikam tattha iva mahantam maṇi khaṇdham 	pidahitvā āviñjana rajjuyaṃ kuñcika muddikam baṇdhi tattha eva mahantam maṇi khaṇdham
dve ghaṭe saṭṭhimattānaṃ tipiṭaka bhikkhunaṃ dveghaṭe aggamahesiyā asaṇdhimittāya	dve ghaṭe bhikkhunam dve ghaṭe aggamahesiyā a saṇdhi mittāya 	dve ghaṭe saṭṭhimattānaṃ tipiṭaka bhikkhunaṃ dve ghaṭe aggamahesiyā a saṇdhi mittāya
hatthapuñchanaka paṭṭaṃdibbañcajānakaṃ āharanti devasikameva panassa anulepagaṇdhaṃ	āharanti devasikam eva panassa anulepa gaṇdham 	hatthapuñchanaka paṭṭaṃ dibbañca jānakaṃ āharanti devasikam eva panassa anulepa gaṇdham
pārupanatthāya asuttamayikaṃ sumanapupphapaṭaṃ mahārahañca añjanaṃ nāgabhavanato	pārupana tthāya sumana puppha paṭam añjanam nāga bhavanataḥ 	pārupana tthāya asuttamayikam sumana puppha paṭam mahārahañca añjanam nāga bhavanato
nāgarājāno āharanti. Chaddantadaheyeva uṭṭhitassa sālino nava cāha sahassāni divase	nāga rājānaḥ āharanti uṭṭhitassa sālinaḥ nava ca āha sahassāni divase 	nāga rājānaḥ āharanti chaddanta daheyeva uṭṭhitassa sālinaḥ nava ca āha sahassāni divase
divase suvā āharanti. Mūsikā nitthusa kaṇe karonti ekopi khaṇḍataṇḍulo na hoti. Rañño	divase āharanti mūsikāḥ kaṇe karonti ekaḥ api khaṇḍa taṇḍulaḥ na hoti rañño 	divase suvā āharanti mūsikā nitthusa kaṇe karonti eko api khaṇḍa taṇḍulo na hoti rañño
samujjalitacārumatthakasobhaṃ nayanarasāyanamiva brahmadeva-manuja nāga-yakkha gaṇānaṃ	samujjalita cāru matthaka sobham nayana rasāyanam iva 	samujjalita cāru matthaka sobham nayana rasāyanam iva brahma deva manuja nāga yakkha gaṇānaṃ
catutthe saṃvacchare buddhasāsane pasīdinaṃ brāhmaṇa jātiya pāsaṇḍānañca paṇḍaraṅga	catutthe saṃvacchare buddha sāsane pasīdinam 	catutthe saṃvacchare buddha sāsane pasīdinam brāhmaṇa jātiya pāsaṇḍānañca paṇḍaraṅga
ettha vasāhiti padāsi. Sā taṃ sālaṃ pāvisi. Gatadivaseyeva puttaṃ vijāyi.	ettha sā tam sālam pāvisi gata divaseya iva puttam 	ettha vasāhiti padāsi sā tam sālam pāvisi gata divaseyeva puttam vijāyi
daṭṭhadivasatoppabhūti taṃ attano sāmidhītaraṃ viya maññamāno nibaddhaṃ vaṭṭaṃ paṭṭhapesi.	tam attanaḥ sāmidhītaram viya maññamānaḥ nibaddham vaṭṭam paṭṭhapesi 	daṭṭhadivasatoppabhūti tam attanaḥ sāmidhītaram viya maññamānaḥ nibaddham vaṭṭam paṭṭhapesi
nāma eko arahā dārakassa hetusampadaṃ disvā viharamāno sattavassikodāni dārako kālo	nāma ekaḥ arahā dārakassa hetu sampadam disvā viharamāno kālo 	nāma eko arahā dārakassa hetu sampadam disvā viharamāno sattavassiko dāni dārako kālo
khuraggeyeva arahattaṃ pāpuṇi. So ekadivasaṃ pātova sarīraṃ paṭijaggitvā ācariyupajjhānaṃ	arahattam pāpuṇi saḥ eka divasam sarīram paṭijaggitvā ācariya upajjhānam 	khuraggeyeva arahattam pāpuṇi so eka divasam pātova sarīram paṭijaggitvā ācariya upajjhānam
Ayaṃ jano sabbopi vikkhittacittohantamagapaṭibhāgo, ayampana dārako avikkhittacitto	ayam janaḥ sabbaḥ api ayam pana dārakaḥ a vikkhitta cittaḥ 	ayam janaḥ sabbaḥ api vikkhitta cittaḥ anta maga paṭibhāgaḥ ayam pana dārakaḥ a vikkhitta cittaḥ
dinnovādaṃ jānāthāti jānami mahārāja ekadesenāti. Tāta, mayhampi naṃ kathehīti sādhu	dinnovādam jānātha ati mahā rāja ekadesena ati tāta nam kathehi iti sādhu 	dinnovādam jānātha iti jānāmi mahā rāja ekadesena ati tāta mayhampi nam kathehi iti sādhu
khaṇḍākhaṇḍaṃ hoti evaṃ tatrāpi alabhitvā allakappaṃ-pāvaṃ-kusināranti sabbattha	khaṇḍākhaṇḍam hoti evam tatra api a labhitvā sabbattha 	khaṇḍākhaṇḍam hoti evam tatra api a labhitvā allakappaṃ pāvaṃ kusināranti sabbattha
nāma rājānaṃ daḷiddarājāti cattu yuttanti punappuna ghaṭetvā dvāraṃ vicaritvā antogehaṃ	nāma rājānam ghaṭetvā dvāram vicaritvā antar geham 	nāma rājānam daḷiddarājāti cattu yuttanti punappuna ghaṭetvā dvāram vicaritvā antar geham
upasampādesi upasampadāmālakeyeva sahapaṭisambhidāhi arahattaṃ pāpuṇi.	upasampādesi saha paṭisambhidāhi arahattam pāpuṇi 	upasampādesi upasampadāmālakeyeva saha paṭisambhidāhi arahattam pāpuṇi
ghosāpetvā chaṇaṃ karothāti amacce āṇāpetvā cattālīsa purisa sahassaparivāro nagarambhā	ghosāpetvā chaṇam karotha ati amacce āṇāpetvā 	ghosāpetvā chaṇam karotha iti amacce āṇāpetvā cattālīsa purisa sahassaparivāro nagarambhā
patta kiñjakkhā hutvā khāyanti sakuṇayaṭṭhiyaṃ haṃsakukkuṭa-jīvaṃjīvakādayo sakuṇā	hutvā khāyanti haṃsa kukkuṭa jīvaṃjīvaka ādayaḥ sakuṇāḥ 	patta kiñjakkhā hutvā khāyanti sakuṇayaṭṭhiyaṃ haṃsa kukkuṭa jīvaṃjīvaka ādayo sakuṇā
pasīditvā pañca rājakakudhabhaṇḍāniceva aññe ca abhisekatthāya bahūpaṇṇākāre pahiṇi.	pasīditvā pañca aññe ca abhiseka thāya bahu paṇṇa ākāre pahiṇi 	pasīditvā pañca rājakakudhabhaṇḍāni ceva aññe ca abhiseka thāya bahu paṇṇa ākāre pahiṇi
therānaṃ abhivādanaṃ pūjāsakkārañca kāronatūti pakkosāpetvā ekamantaṃ nisīdi. Thero	abhivādanam pūjā sakkāram ca ekamantam nisīdi theraḥ 	therānam abhivādanam pūjā sakkāram ca kāronatu iti pakkosāpetvā ekamantam nisīdi thero
tvaṃ mahārāja evaṃ kilama māno āgatoti. Tumhe mama gāḷhaṃ ovādaṃ datvā idāni gantukāmā	tvam mahā rājaḥ evam tumhe mama gāḍham ovādam idāni gantu kāmā 	tvam mahā rāja evam kilama māno āgato iti tumhe mama gāḍham ovādam datvā idāni gantu kāmā
mahānāgavanuyyānābhimukho yā hi addhā tasmiṃ ṭhāne dhātuyo lacchasiti, rājā sādhūti	mahā nāgavan uyyāna abhimukhaḥ hi addhā tasmin ṭhāne rājā sādhu iti 	mahā nāgavan uyyāna abhimukhaḥ yā hi addhā tasmin ṭhāne dhātuyo lacchasi iti rājā sādhu iti
tatotumhe dakkhiṇadāṭhaṃpūjetha, dakkhiṇakkhakaṃ pana mayhaṃ dethāti, evañca naṃ	tato tumhe dakkhiṇa kkhakam pana mayham detha ati evam ca naṃ 	tato tumhe dakkhiṇa dāṭhaṃ pūjetha dakkhiṇa kkhakam pana mayham detha ati evam ca naṃ
ubbaṭṭetvā varamuttasadisānaṃ dhātūnaṃ pūretvā adāsi.	ubbaṭṭetvā dhātūnam pūretvā adāsi 	ubbaṭṭetvā varamuttasadisānaṃ dhātūnaṃ pūretvā adāsi
asokadhammarājena dinna dhātuyo cetiyagiriyamhiyeva patiṭṭhāpetvā dakkhiṇakkhakaṃ	asokadhammarājena dinna patiṭṭhāpetvā dakkhiṇakkhakam 	asokadhammarājena dinna dhātuyo cetiyagiriyamhiyeva patiṭṭhāpetvā dakkhiṇakkhakaṃ
na deti. Theraṃ pucchi, kasmā bhante nāgo dhātuṃ oropetuṃ na detīti	na deti theram pucchi kasmai bhante nāgaḥ dhātum na deti iti 	na deti theraṃ pucchi kasmā bhante nāgo dhātuṃ oropetuṃ na deti iti
ca deviyo ca de-nāga-yakkhānaṃ vimbhayakaraṃ paccekaṃ thūpamakaṃsu.	ca deviyo ca denāgayakkhānam paccekam 	ca deviyo ca denāgayakkhānam vimbhayakaram paccekam thūpamakaṃsu
Senāya samussita dhajapatākaṃ nānāratana vicittaṃ anekālaṅkāra patimaṇḍitaṃ nānāvidha	dhaja patākam nānā ratana vicittam aneka alaṅkāra patimaṇḍitam nānāvidha 	Senāya samussita dhaja patākam nānā ratana vicittam aneka alaṅkāra patimaṇḍitam nānāvidha
pakkhaṇdi mahāsamuddepi samantā yojanaṃ vīci vūpasantā pañcavaṇṇāni padumāni pupphitāni	samantā yojanam pañca vaṇṇāni padumāni pupphitāni 	pakkhaṇdi mahāsamuddepi samantā yojanaṃ vīci vūpasantā pañcavaṇṇāni padumāni pupphitāni
ativiya uḷāra pūjā ahosi. Evaṃ mahatiyā pūjāya sā nāvā jambukolapaṭṭanaṃ pāvisi.	evam mahatiyā pūjāya sā nāvā jambu kola paṭṭanam pāvisi 	ativiya uḷāra pūjā ahosi evam mahatiyā pūjāya sā nāvā jambu kola paṭṭanam pāvisi
samuddato paccuttaritvā samuddatīre bodhiṃ ṭhapetvā tīṇi divasāni sakala tambapaṇṇi rajjena pūjesi.	paccuttaritvā samudda tīre bodhim ṭhapetvā tīṇi divasāni rajjena pūjesi 	samuddato paccuttaritvā samudda tīre bodhim ṭhapetvā tīṇi divasāni sakala tambapaṇṇi rajjena pūjesi
pattaṃ pana rāja geheyava ṭhapetvā pūjamakāsīti.	pattam pana rāja ṭhapetvā pūjam akāsi iti 	pattam pana rāja gehe eva ṭhapetvā pūjam akāsi iti
Kārāpesi mahārāja-thūpe yojana yojaneti;	mahārājathūpe yojana yojana iti 	Kārāpesi mahārājathūpe yojana yojana iti
devī attano puttassa rajjaṃ icchanti taracchanāvā vāpiṃ karontassa uparājassavisena	devī attano puttassa rajjam icchanti vāpim karontassa 	devī attano puttassa rajjam icchanti taracchanāvā vāpim karontassa uparājassa visena
So na icchi, yāpi punappuna yāciyeva. Sāmaṇeropi evaṃ sante sāsanānuggahaṃ kātuṃ	saḥ naḥ icchi yā api punappuna sāmaṇeraḥ api evam sante sāsana anuggaham kātum 	so na icchi yā api punappuna yāci eva sāmaṇero api evaṃ sante sāsana anuggahaṃ kātuṃ
Sā dasamāsaccayena puttaṃ vijāyi. Tassa gāmaṇi abhayoti nāmaṃ kariṃsu. Aparabhāge	sā dasa māsa cayena puttam tassa nāmam kariṃsu aparabhāge 	sā dasa māsa accayena puttaṃ vijāyi tassa gāmaṇi abhayo iti nāmaṃ kariṃsu aparabhāge
Tesaṃ uppattikathā mahāvaṃsato gahetabbā rājā dasamahāyodhānaṃ puttassa sakkārasamaṃsakkāraṃ	tesam uppatti kathā mahā vaṃsataḥ gahetabbā rājā dasa mahā yodhānam puttassa 	tesam uppatti kathā mahā vaṃsataḥ gahetabbā rājā dasa mahā yodhānam puttassa sakkāra samam sakkāram
kālamakāsi tissakumāro pitukālakatabhāvaṃ sutvā dīghavāpito āgantvā pitu sarīrakiccaṃ	tissa kumāraḥ pitu kāla kata bhāvam sutvā dīgha vāpitaḥ āgantvā sarīra kiccam 	kāla makāsi tissa kumāro pitu kāla kata bhāvam sutvā dīgha vāpito āgantvā pitu sarīra kiccam
apesana bhāvaṃ ñatvā yuddhāya nikkhami. Kumāropi yuddhasajjohutvānikkhami. Cuḷaṅgaṇiya	apesana bhāvam ñatvā yuddhāya nikkhami kumāraḥ api cuḷaṅgaṇiya 	apesana bhāvam ñatvā yuddhāya nikkhami kumāro api yuddhasajjo hutvā nikkhami cuḷaṅgaṇiya
Te kira yodhā sapathassa katattā tesaṃ yuddhe sahāyā na bhaviṃsu. Tadā rañño anekasahassa	te kira sapathassa tesam yuddhe sahāyāḥ na bhaviṃsu tadā raññaḥ 	te kira yodhā sapathassa katattā tesaṃ yuddhe sahāyā na bhaviṃsu tadā rañño anekasahassa
Rājā kālaṃ sallakkhetvā saṅghassa datvā bhuñjāmiti saṅghassa-amaccassa-vaḷavāya-attano	rājā kālam sallakkhetvā saṅghassa da tvā bhuñjāmiti 	rājā kālam sallakkhetvā saṅghassa da tvā bhuñjāmiti saṅghassa amaccassa vaḷavāya attano
cāti catubhāgaṃ katvā kālā ghosāpesi tadā piyaṅgudipato kuṭumbiyatissatthero nāma	ca ati catu bhāgam katvā tadā kuṭumbiyatissa theraḥ nāma 	ca ati catu bhāgam katvā kālā ghosāpesi tadā piyaṅgudipato kuṭumbiyatissa thero nāma
Saraṇesu ca sīlesu-ṭhitā āsuṃ asaṅkhiyā;	saraṇesu ca sīlesu ṭhitāḥ āsum 	saraṇesu ca sīlesu ṭhitā āsum asaṅkhiyā
Sotāpattiphalaṃ patvā-sele sumanakūṭake,	sa utāpatti phalam sumanakūṭake 	sa utāpatti phalam patvā sele sumanakūṭake
Evamaccāyikaṃ kammaṃ-karontāpi guṇākarā, karonti puññaṃ sappaññā-saṃsārabhasa bhīrukāti.	evam accāyikam kammaṃkarontā api guṇa ākarā karonti puññam bhīrukā ati 	evam accāyikam kammaṃ karontā api guṇa ākarā karonti puññam sappaññā saṃsāra bhasa bhīrukā ti
damiḷaṃ-hālakole mahissariya damiḷaṃ-nāḷisobbhe nāḷika damiḷaṃ-dighābhasagallamhi	mahissariya damiḷaṃ nāḷisobbhe nāḷika 	damiḷaṃ hālakole mahissariya damiḷaṃ nāḷisobbhe nāḷika damiḷaṃ dighābhasagallamhi
tato veṭha nagare tāḷa damiḷaṃ, bhāṇakadamiḷañca-vahiṭṭhe vahiṭṭha damiḷaṃ=gāmaṇimhi	tatas veṭha nagare tāḷa damiḷam vahiṭṭha damiḷaṃgāmaṇimhi 	tato veṭha nagare tāḷa damiḷaṃ bhāṇakadamiḷañca vahiṭṭhe vahiṭṭha damiḷaṃgāmaṇimhi
khāṇu damiḷaṃ-tambunnagāmake mātula bhāgineyye dve damiḷe gaṇhi tadā-	mātula bhāgineyye dve damiḷe tadā 	khāṇu damiḷaṃ tambunnagāmake mātula bhāgineyye dve damiḷe gaṇhi tadā
Jālavaṇṇaṃva hotūti-taṃ tatheva tadā ahu;”	jāla vaṇṇam iva hotu utitam tathā iva tadā ahu 	jāla vaṇṇam iva hotu iti tam tathā eva tadā ahu
kaṇḍulaṃ muñcesi. Kaṇḍulopi taṃ gaṇhituṃ āgañchi tadā naṇdhimitto hatthetahi ubho	kaṇḍulam muñcesi kaṇḍulaḥ api tam gaṇhitum tadā naṇdhi mittaḥ ubho 	kaṇḍulam muñcesi kaṇḍulaḥ api tam gaṇhitum āgañchi tadā naṇdhi mittaḥ hatthetahi ubho
kaṇḍulo jāṇuhi ṭhatvā silā sudhā iṭṭhakā bhiṇditvā ayodvāraṃ pāpuṇi tadā damiḷā gopure	kaṇḍulaḥ silā sudhā iṭṭhakā bhiṇditvā ayaḥ dvāram tadā damiḷā gopure 	kaṇḍulaḥ jāṇuhi ṭhatvā silā sudhā iṭṭhakā bhiṇditvā ayaḥ dvāram pāpuṇi tadā damiḷā gopure
ṭhatvā nānāvudhāni khipiṃsu pakka ayoguḷe cevapakkaṭṭhita silesañca hatthipiṭṭhiyaṃ	ṭhatvā nānā vudhāni ayaḥ guḷe silesam ca hatthipiṭṭhiyam 	ṭhatvā nānā vudhāni khipiṃsu pakka ayaḥ guḷe ceva pakkaṭṭhita silesam ca hatthipiṭṭhiyam
pakkhipiṃsu? Tadā kaṇḍulo vedanaṭṭo udakaṭṭhānaṃ gantvā udake ogāhi. Tadā goṭhayimbaro	tadā kaṇḍulaḥ vedanaṭṭaḥ udaka ṭṭhānam gantvā udake ogāhi tadā goṭha yimbaraḥ 	pakkhipiṃsu tadā kaṇḍulo vedanaṭṭo udaka ṭṭhānaṃ gantvā udake ogāhi tadā goṭha yimbaro
tassupari telacammaṃ baṇdhitvā taṃ vissajjesi so asani viyagajjanto gantvā dāṭhāhi	tassa upari tela cammam baṇdhitvā tam vissajjesi saḥ asani gantvā 	tassa upari tela cammam baṇdhitvā tam vissajjesi so asani viya gajjanto gantvā dāṭhāhi
laḍḍītvā nagarabbhantare pati goṭhayimbaropi - soṇopi - theraputtābhayopi ekeka dvāraṃ	laḍḍītvā nagara bbhantare pati goṭha yimbaraḥ api soṇaḥ api dvāraṃ 	laḍḍītvā nagara bbhantare pati goṭha yimbaraḥ api soṇaḥ api theraputta ābhayaḥ api ekeka dvāraṃ
“Hatthi gahetvā rathacakkaṃ-mitto sakaṭa pañjaraṃ,	hatthi gahetvā sakaṭa pañjaram 	hatthi gahetvā rathacakkaṃ mitto sakaṭa pañjaraṃ
Nāḷikerataruṃ goṭho-nimmalo khaggamuttamaṃ;	nāḷikera tarum khaggam uttamam 	nāḷikera tarum goṭho nimmalo khaggam uttamam
dīghajantu paṭhamaṃ imaṃ māremīti kujjhitvā ākasamabbhuggantvā attanopari otarantaṃ	paṭhamam imam mā āremi iti kujjhitvā ākasam abbhut gantvā attanā upari otarantam 	dīghajantu paṭhamam imam māremī iti kujjhitvā ākasam abbhuggantvā attano upari otarantam
mīti cintetvā phalakaṃ pahari. Itaro phalakaṃ muñci, dīghajantu phalakaṃ chiṇdanto	cintetvā phalakam itaraḥ phalakam muñci phalakam 	mīti cintetvā phalakaṃ pahari itaro phalakaṃ muñci dīghajantu phalakaṃ chiṇdanto
Carāpetvā tahiṃ bheriṃ-duṭṭhagāmiṇi bhūpati,	tahim bheriṃduṭṭha gāmiṇi bhūpati 	Carāpetvā tahiṃ bheriṃ duṭṭha gāmiṇi bhūpati
Tato vijita saṅgāmo-sayoggabalavāhano,	tatas saṅgā mosa yogga bala vāhanaḥ 	tato vijita saṅgāmo sa yogga bala vāhano
kāretvā parihāramadāsi. Ajjapi rājāno taṃ padesampatvā bheriṃ na vādāpenti. Evaṃ	kāretvā ajja pi rājānaḥ tam padesam patvā bherim na evam 	kāretvā parihāram adāsi ajja pi rājāno tam padesam patvā bherim na vādāpenti evam
duṭṭhagāmaṇi abhaya mahārājā dvattiṃsa damiḷa rājāno māretvā laṅkādīpaṃ ekacchattamakāsi.	abhaya mahā rājā dvattiṃsa damiḷa rājānaḥ māretvā laṅkā dīpam 	duṭṭha gāmaṇi abhaya mahā rājā dvattiṃsa damiḷa rājāno māretvā laṅkā dīpaṃ eka chattam akāsi
Yadā duṭṭhagāmaṇi vijitaṃ nagaraṃ gaṇhi tadā dīghajantu yodho eḷāraṃ upasaṅkamitvā	yadā vijitam nagaram tadā dīghajantu yodhaḥ eḷāram upasaṅkamitvā 	yadā duṭṭhagāmaṇi vijitam nagaram gaṇhi tadā dīghajantu yodho eḷāram upasaṅkamitvā
rājābhimukho agañchi. Tadā kaṇḍulo tassa vegamaṇdi bhāvatthaṃ sanikaṃ sanikaṃ paccosakaki	rāja abhimukhaḥ agañchi tadā kaṇḍulaḥ tassa bhāvattham sanikam sanikam 	rāja abhimukhaḥ agañchi tadā kaṇḍulaḥ tassa vega aṇdi bhāvattham sanikam sanikam paccosakaki
senāpi hatthinā saddhiṃ tatheva paccosakaki.	senā api hatthinā saddhim tathā iva 	senā api hatthinā saddhim tathā eva paccosakaki
taṃ akkosi rañño mukhe vijjhissāmīti saraṃ khipi. So khaggatala māgaccabhūmiyaṃ pati,	tam raññaḥ mukhe vijjhissāmi iti saram khipi saḥ 	tam akkosi rañño mukhe vijjhissāmi iti saram khipi so khaggatala māgaccabhūmiyam pati
idañcidañca kāressatīti sutvā haṭṭho udaggo appoṭhesi-ayyena kira vatamhi diṭṭho mahā mahiṇdenāti.	idam ca idam ca kāressati iti sutvā haṭṭhaḥ udaggaḥ kira vatamhi diṭṭhaḥ mahā mahiṇdena ati 	idam ca idam ca kāressati iti sutvā haṭṭho udaggo appoṭhesi ayyena kira vatamhi diṭṭho mahā mahiṇdena iti
ca. Vessavanassa nārivābhanayānaṃ sutvā tadākāraṃ majjhe ratana maṇḍapaṃ kāresi.	ca vessavanassa sutvā tad ākāram majjhe maṇḍapam kāresi 	ca vessavanassa nārivābhanayānaṃ sutvā tad ākāram majjhe ratana maṇḍapam kāresi
sattaratana vicittamaṇḍapa majjhe pana eḷikamaya bhūmiyā dantamaya pallaṅko ahosi	majjhe pana eḷika maya bhūmiyā danta maya pallaṅkaḥ ahosi 	satta ratana vicitta maṇḍapa majjhe pana eḷika maya bhūmiyā danta maya pallaṅko ahosi
tepiṭakā, tatiyādisu tīsu bhūmisu kamena sotāpanna - sakadāgāmi - anāgāmino, upari	tepiṭakā tatiya ādisu tīsu bhūmisu upari 	tepiṭakā tatiya ādisu tīsu bhūmisu kamena sotāpanna sakadāgāmi anāgāmino upari
taṃyeva iṭṭhaka gopanaṃ kāresi. Tato rājā ahameva iṭṭhakolokanatthāya gacchāmi -	gopanam kāresi tatas rājā aham eva iṭṭhaka olokana tthāya gacchāmi 	tam yeva iṭṭhaka gopanam kāresi tato rājā aham eva iṭṭhaka olokana tthāya gacchāmi
peḷivāpi gāmassa vāpiyā otiṇṇa kaṇdare pulina puṭṭhe nisadapotappamāṇa dīghato vidatthicaturaṅgulā	gāmassa vāpiyā otiṇṇa kaṇdare pulina puṭṭhe dīghataḥ vidatthi catur aṅgulā 	peḷivāpi gāmassa vāpiyā otiṇṇa kaṇdare pulina puṭṭhe nisadapotappamāṇa dīghato vidatthi catur aṅgulā
iṭṭhakā attharāpesi. Iṭṭhakopari kharasukammaṃ, tassoparikuruviṇdapāsāṇaṃ, tassopariayojālaṃ,	iṭṭhakā iṭṭhakā upari kharasukammam tassa upari kuruviṇda pāsāṇam tassa upari ayojālam 	iṭṭhakā attharāpesi iṭṭhakā upari kharasukammam tassa upari kuruviṇda pāsāṇam tassa upari ayojālam
tassopari tilatelayantintāya manosilāya sattaṅgula bahalaṃ rajatapaṭṭaṃ attharāpesi	tassa upari manosilāya bahalam rajata paṭṭam attharāpesi 	tassa upari tila tela yantintāya manosilāya sattaṅgula bahalam rajata paṭṭam attharāpesi
alasaṇdā nagarato yonaka dhammarakkhitatthero tiṃsa bhikkhu sahassāni. Viñjhāṭavivattaniya	alasaṇdā nagarataḥ dhammarakkhita thero tiṃsa bhikkhu sahassāni 	alasaṇdā nagarato yonaka dhammarakkhita thero tiṃsa bhikkhu sahassāni viñjhāṭavivattaniya
adhippāyaṃ ñatvā tathā ṭhitāti vadantī siddhatthero pana maṅgalo-sumano-padumo-sīvali-caṇdagutto-sūriyagutto-iṇdagu-	adhippāyam ñatvā tathā ṭhitā ati vadantī siddha ttheraḥ pana 	adhippāyam ñatvā tathā ṭhitā ati vadantī siddha ttheraḥ pana maṅgalo sumano padumo sīvali caṇdagutto sūriyagutto iṇdagu
tto-sāgaro-cittaseno -jayaseno-acaloti imehi ekādasahi therehi parivuto puṇṇaghaṭe	imehi ekādasahi therehi parivutaḥ puṇṇa ghaṭe 	tto sāgaro cittaseno jayaseno acaloti imehi ekādasahi therehi parivutaḥ puṇṇa ghaṭe
paribbhamana daṇḍaṃ vijjamānamātāpitūnaṃ ubhato sujātena sumaṇḍita pasādhitena abhimaṅgala	daṇḍam vijjamāna mātā pitūnam ubhatas su jātena su maṇḍita pasādhitena 	paribbhamana daṇḍam vijjamāna mātā pitūnam ubhato su jātena su maṇḍita pasādhitena abhimaṅgala
nāmaṃ pucchitvā gaṇdhamālādīhi pūjetvā vambatvā parivāretvā ṭhite sesa ekādasa there	nāmam pucchitvā gaṇdha mālā ādīhi pūjetvā parivāretvā ṭhite there 	nāmam pucchitvā gaṇdha mālā ādīhi pūjetvā vambatvā parivāretvā ṭhite sesa ekādasa there
Atha aṭṭha suvaṇṇiṭṭhakā ṭhapāpesi. Tāsu ekekaṃ parivāretvā aṭṭhuttarasata aṭṭhuttarasata	atha aṭṭha tāsu ekekam parivāretvā aṭṭhuttara sata aṭṭhuttara sata 	atha aṭṭha suvaṇṇiṭṭhakā ṭhapāpesi tāsu ekekam parivāretvā aṭṭhuttara sata aṭṭhuttara sata
Tasmiṃ khaṇe mittatthero nāma puratthima disābhāge paribbhamita lekhāya bhūmiyaṃ	tasmin khaṇe mitta theraḥ nāma puratthima disā bhāge lekhāya 	tasmin khaṇe mitta theraḥ nāma puratthima disā bhāge paribbhamita lekhāya bhūmiyaṃ
21. Tato rājā bhikkhusaṅghaṃ vaṇditvā yāca mahācetiyaṃ niṭṭhātināva me bhikkhusaṅgho	tatas rājā bhikkhu saṅgham vaṇditvā yāca mahā cetiyam me bhikkhu saṅghaḥ 	tatas rājā bhikkhu saṅgham vaṇditvā yāca mahā cetiyam niṭṭhāti nāva me bhikkhu saṅghaḥ
vaḍḍhaki santipātesi. Te pañcasatamattā ahesuṃ.	vaḍḍhaki te pañca sata mattāḥ ahesuṃ 	vaḍḍhaki santipātesi te pañca sata mattāḥ ahesuṃ
Rājā tassa saññaṃ adāsi. To tvaṃ tayo jātisumana makulakumbhe mahābodhi aṅgaṇe rāsiṃ	rājā tassa saññam adāsi to tvam aṅgaṇe 	rājā tassa saññam adāsi to tvam tayo jātisumana makulakumbhe mahābodhi aṅgaṇe rāsim
ahosi. So āgantvā vaḍḍhakinā saddhiṃ mantetvā dīgha bahala kiriyato iṭṭhakappamāṇaṃ	ahosi saḥ āgantvā vaḍḍhakinā saddhim mantetvā 	ahosi saḥ āgantvā vaḍḍhakinā saddhim mantetvā dīgha bahala kiriyato iṭṭhakappamāṇaṃ
āgantukā nevāsikāti pucchi. Āgantukomhī upāsakāti. Katara raṭṭhavāsiko bhanteti koṭṭhivālajanapade	āgantukā nevāsikā ati upāsakā ati raṭṭhavāsikaḥ bhante iti koṭṭhivāla janapade 	āgantukā nevāsikā iti pucchi āgantuko amhi upāsakā ati katara raṭṭhavāsikaḥ bhante iti koṭṭhivāla janapade
Tumhākaṃ sarīrālokena sakalatambapaṇṇidipo ekāloko, kiṃ kammaṃ karitthāti bhante	tumhākam sarīra ālokena eka āloko kim kammam karittha ati bhante 	tumhākam sarīra ālokena sakala tambapaṇṇi dipo eka āloko kim kammam karittha ati bhante
rājā bhikkhusaṅghaṃ gaṇdhamālādīhi pūjetvā vaṇditvā pucchi’bhante mahācetiye pupphadhānattayaṃ	rājā bhikkhu saṅgham gaṇdha mālā ādīhi pūjetvā vaṇditvā mahā cetiye 	rājā bhikkhu saṅgham gaṇdha mālā ādīhi pūjetvā vaṇditvā pucchi bhante mahā cetiye pupphadhāna ttayaṃ
āharathāti. Te sādhūti sampaṭicchitvā uttarakuruṃ gantvā cuttappakārappamāṇe bhaṇḍipupphanihecha	āharatha ati te sādhu iti sampaṭicchitvā uttarakurum gantvā cutta ppakāra ppamāṇe 	āharatha ati te sādhu iti sampaṭicchitvā uttarakurum gantvā cutta ppakāra ppamāṇe bhaṇḍi puppha nihecha
phalā pavāḷamayāni. Tathā aṅkuropari celavitānaṃ baṇdhāpesi. Tassa ante samannato	tathā aṅkura upari cela vitānam baṇdhāpesi tassa ante samannataḥ 	phalā pavāḷamayāni tathā aṅkura upari cela vitānam baṇdhāpesi tassa ante samannato
muttamaya kiṅkiṇikajālaṃ olambati. Svaṇṇaghaṇṭāpanti ca suvaṇṇadāmāni ca tahiṃ tahiṃ	kiṅkiṇika jālam olambati ca suvaṇṇa dāmāni ca tahim tahim 	muttamaya kiṅkiṇika jālam olambati svaṇṇa ghaṇṭā panti ca suvaṇṇa dāmāni ca tahim tahim
olambanti vitānassa catusu kaṇṇesu navasatasahassagghanako ekeko muttākalāpo olambati.	olambanti vitānassa catusu kaṇṇesu ekekaḥ muttā kalāpaḥ olambati 	olambanti vitānassa catusu kaṇṇesu navasatasahassagghanako ekeko muttā kalāpo olambati
Tattha yathānurūpaṃ nānāratana katāneva caṇda-sūriya-tārakārūpāni padumāni ca appitāni	tattha yathānurūpam caṇda sūriya tārakā rūpāni padumāni ca 	tattha yathānurūpaṃ nānāratana katāneva caṇda sūriya tārakā rūpāni padumāni ca appitāni
muttā vedikānaṃ antare gaṇdhodaka puṇṇa sattaratanamaya puṇṇaghaṭa pantiyo ṭhapāpesi.	vedikānaṃ antare gaṇdha udaka puṇṇa satta ratana maya puṇṇa ghaṭa 	muttā vedikānaṃ antare gaṇdha udaka puṇṇa satta ratana maya puṇṇa ghaṭa pantiyo ṭhapāpesi
Maṇighaṭe rajatamayāni pupphāni rajataghaṭe maṇimayānipupphāti. Sattaratanaghaṭe	maṇi ghaṭe rajata mayāni pupphāni rajata ghaṭe satta ratana ghaṭe 	maṇi ghaṭe rajata mayāni pupphāni rajata ghaṭe maṇi mayāni pupphāti satta ratana ghaṭe
Vasavattimārampana bāhusahassaṃ māpetvā tisūla muggarādi nānāvudhāni gahetvā sahassakumbhaṃ	bāhu sahassam māpetvā muggara ādi nānā vudhāni gahetvā sahassa kumbham 	Vasavatti māram pana bāhu sahassam māpetvā ti sūla muggara ādi nānā vudhāni gahetvā sahassa kumbham
tebhātika jaṭila damanaṃ, laṭṭhivanuyyāne bimbisāropagamaṇaṃ, rājagahappavesanaṃ,	damanam laṭṭhivan uyyāne bimbisāra upagamaṇam rāja gaha ppavesanam 	tebhātika jaṭila damanam laṭṭhivan uyyāne bimbisāra upagamaṇam rāja gaha ppavesanam
Abhidhamma desanā devorohaṇa pāṭīhīraṃ therapañha samāgamañca kāresi.	abhidhamma desanā thera pañha samāgamam ca kāresi 	abhidhamma desanā devorohaṇa pāṭīhīraṃ thera pañha samāgamam ca kāresi
Tathā mahāsamayasutta-rāhulovāda sutta-maṅgasuttapārāyana sutta samāgamaṃ dhanapāla-āḷavaka-aṅgulimāla-apalāla	tathā dhanapāla āḷavaka aṅgulimāla apalāla 	tathā mahāsamayasutta rāhulovāda sutta maṅgasutta pārāyana sutta samāgamaṃ dhanapāla āḷavaka aṅgulimāla apalāla
dvinnaṃ udakadhārānaṃ patanaṃ uttarābhimukhaṃ sattapadavītihāra gamanaṃ kāḷadevaḷassa	patanam uttara abhimukham gamanam kāḷadevaḷassa 	dvinnam udakadhārānam patanam uttara abhimukham sattapadavītihāra gamanam kāḷadevaḷassa
uyyānasiriṃ anubhavitvā sāyaṇha samaye nahātvā maṅgala silāpaṭṭe nisinnamatta vissakaṭṭhānā	uyyāna sirim anubhavitvā sāyaṇha samaye maṅgala silā paṭṭe 	uyyāna sirim anubhavitvā sāyaṇha samaye nahātvā maṅgala silā paṭṭe nisinnamatta vissakaṭṭhānā
varamāruyha) mahābhinikkhamaṇaṃ nikkhamitaṭṭhānaṃ dasa sahassa) cakkavāḷa devatāhi	varam āruyha mahābhinikkhamaṇam nikkhamita ṭṭhānam dasa devatāhi 	varam āruyha mahābhinikkhamaṇam nikkhamita ṭṭhānam dasa sahassa cakkavāḷa devatāhi
khaggadharā devatāyo tato pañcahatthappamāṇa gaṇdhitelapūritā dukūlavaṭṭiyaṃ pajjalita	khagga dharāḥ devatāyaḥ tatas gaṇdhi tela pūritāḥ dukūla vaṭṭiyam 	khagga dharā devatāyo tato pañca hattha pamāṇa gaṇdhi tela pūritā dukūla vaṭṭiyaṃ pajjalita
suvaṇṇa-maṇi-mutta-vajirānaṃ cattāro rāsiyo kāresi tato meghavaṇṇa pāsāṇabhittiyaṃ	cattāraḥ rāsiyaḥ kāresi tatas meghavaṇṇa pāsāṇa bhittiyam 	suvaṇṇa maṇi mutta vajirānaṃ cattāro rāsiyo kāresi tato meghavaṇṇa pāsāṇa bhittiyaṃ
vijjullatā kāresi tato ratana latāyo tato cāḷavijatiyo tato niluppale gahetvā ṭhita	vijjullatā kāresi tatas tatas tatas 	vijjullatā kāresi tato ratana latāyo tato cāḷavijatiyo tato niluppale gahetvā ṭhita
kāresīti. Ettha ca vuttappakārampana pūjanīyabhaṇḍaṃ anantamaparimāṇaṃ hoti tathā	kāresi iti ettha ca pūjanīya bhaṇḍam anantama parimāṇam hoti tathā 	kāresi iti ettha ca vuttappakāram pana pūjanīya bhaṇḍam anantam aparimāṇam hoti tathā
hi ambapāsānavāsī cittaguttattheronāma heṭṭhā lohapāsāde sannipatitānaṃ dvādasannaṃ	hi ambapāsānavāsī cittagutta theraḥ nāma heṭṭhā loha pāsāde 	hi ambapāsānavāsī cittagutta thero nāma heṭṭhā loha pāsāde sannipatitānaṃ dvādasannaṃ
tava kathāto parihīnampi atthi. Apacco sakakitvā vitthārena kathehīti āha. Atha imasmiṃyeva	tava kathātaḥ parihīnam api atthi vitthārena kathehi iti āha atha imasmiṃyeva 	tava kathāto parihīnam api atthi apacco sakakitvā vitthārena kathehi iti āha atha imasmiṃyeva
adhikāraṃ kathetvā pariyosāpetumasakkāntoseva uṭṭhāsi. Tattheko bhikkhu rājānaṃ pucchi-mahārāja	adhikāram kathetvā uṭṭhāsi tattha ekaḥ bhikkhu rājānam pucchi mahā rāja 	adhikāram kathetvā pariyosāpetum asakkonto eva uṭṭhāsi tattha eko bhikkhu rājānam pucchi mahā rāja
tāva dhātugabbho yāva mahācetiye vāluka pākāra paricchedā nirantaraṃ puretumpi na	tāva dhātu gabbhaḥ yāva mahā cetiye na 	tāva dhātu gabbhaḥ yāva mahā cetiye vāluka pākāra paricchedā nirantaraṃ puretumpi na
Kammādhiṭṭhāyako ettha-sabbaṃ saṃvidahi imaṃ;	kamma adhiṭṭhāyakaḥ ettha sabbam imam 	kamma adhiṭṭhāyakaḥ ettha sabbam saṃvidahi imam
otarantuti. Sakkopi vissakammaṃ āṇāpesi-sve mahācetiye dhātunidhānaṃ bhavissati.	otarantu ti mahā cetiye dhātu nidhānam bhavissati 	otarantu ti sakkopi vissakammam āṇāpesi sve mahā cetiye dhātu nidhānam bhavissati
Dhātu ānubhāvena sakala cakkavāḷaṃ gabbhokkamanābhisambodhikālādisu viya sajjitaṃ	sakala cakkavāḷam gabbha ukkamana abhisambodhi kāla ādisu sajjitam 	Dhātu ānubhāvena sakala cakkavāḷam gabbha okkamana abhisambodhi kāla ādisu viya sajjitam
pupphāni samokiritvā nānāvirāga dhajapaṭākāyo ussāpetvā suvaṇṇaghaṭa kadalitoraṇa	pupphāni samokiritvā ussāpetvā suvaṇṇa ghaṭa kadali toraṇa 	pupphāni samokiritvā nānāvirāga dhajapaṭākāyo ussāpetvā suvaṇṇa ghaṭa kadali toraṇa
Atha rājā sabbābharaṇa vibhūsito kumuda pannavaṇṇa catusiṇdhavayutta rathavaramāruyha	atha rājā sabba ābharaṇa vibhūsitaḥ ratha varam āruyha 	atha rājā sabba ābharaṇa vibhūsitaḥ kumuda panna vaṇṇa catu sindhava yutta ratha varam āruyha
devakaññupamā aneka sahassa nāṭakitthiyo ceva dasamahāyodhā ca caturaṅginī senā ca	aneka sahassa ca iva dasa mahā yodhā ca caturaṅginī senā ca 	deva kaññupamā aneka sahassa nāṭakitthiyo ca eva dasa mahā yodhā ca caturaṅginī senā ca
nānāvaṇṇa dhaje ca gahetvā parivāresuṃ. Evaṃ rājā mahantena rājānubhāvena naṇdanavanaṃ	ca gahetvā evam rājā mahantena rāja anubhāvena naṇdana vanam 	nānāvaṇṇa dhaje ca gahetvā parivāresuṃ evaṃ rājā mahantena rāja anubhāvena naṇdana vanaṃ
Mahārāja tambapaṇṇidīpe duṭṭhagāmaṇi abhaya mahārājā mahā cetiyaṃ kārento dhātuyo	mahā rāja tambapaṇṇi dīpe abhaya mahā rājā mahā cetiyam kārentaḥ 	mahā rāja tambapaṇṇi dīpe duṭṭhagāmaṇi abhaya mahā rājā mahā cetiyam kārentaḥ dhātuyo
kathetvā dhātuyo āharāti maṃ pesesuṃ, tasmā idhāgatomhīti āha.	kathetvā mam pesesum tasmai idha āgataḥ asmi iti āha 	kathetvā dhātuyo āharāti maṃ pesesuṃ tasmā idha āgato asmi iti āha
dhātuyo. Saṃsāradukkhamokkhāya-uppajjanta tathāgatā, buddhassa vetthādīppāyo-tena	dhātuyaḥ saṃsāra dukkha mokkhāya uppajjanta tathāgatāḥ buddhassa 	dhātuyaḥ saṃsāra dukkha mokkhāya uppajjanta tathāgatāḥ buddhassa vetthā dīppāyo tena
Tasmā papañcamakaritvā-lahuṃ me dehi dhātuye”ti-āha. Evaṃ vutte nāgarājā appaṭihāno	tasmai me dehi dhātuyā iti āha evam vutte nāga rājā appaṭihānaḥ 	tasmā papañcam akaritvā lahuṃ me dehi dhātuyā iti āha evaṃ vutte nāga rājā appaṭihāno
“Bhāgineyyo’tha kucchimhi-apassitvā karaṇḍakaṃ,	kucchimhi a passitvā karaṇḍakam 	Bhāgineyyo atha kucchimhi a passitvā karaṇḍakam
labhitvā cīraparihaṭa dhātuyo kasmā anavasesaṃ katvā aharāpetha amhākaṃ saggamokkhantarāyaṃ karothāti.	labhitvā kasmai anavasesam katvā aharāpetha amhākam sagga mokkha antarāyam karotha ati 	labhitvā cīraparihaṭa dhātuyo kasmā anavasesaṃ katvā aharāpetha amhākaṃ sagga mokkha antarāyaṃ karotha iti
Maṇitālavaṇṭaṃ suyāmo-sakko saṅkhantu sodakaṃ;	maṇi tāla vaṇṭam saṅkhantu sa udakam 	maṇi tāla vaṇṭam suyāmo sakko saṅkhantu sa udakam
Cattāro tu mahārāja-aṭṭhaṃsu khaggapāṇino,	cattāraḥ tu mahā rāja khagga pāṇinaḥ 	cattāro tu mahā rāja aṭṭhaṃsu khagga pāṇino
dhātumatthake setacchattaṃ dissati chattagāhaka brahmā na dissati. Tathā tālavaṇṭa	dhātumatthake seta chattam dissati brahmā na dissati tathā 	dhātumatthake seta chattam dissati chattagāhaka brahmā na dissati tathā tālavaṇṭa
datvā taṃ divasaṃ sakalatambapaṇṇi dīpe rajjaṃ adāsi.	da tvā tam divasam dīpe rajjam adāsi 	datvā taṃ divasaṃ sakala tambapaṇṇi dīpe rajjaṃ adāsi
dhātuyo ākāsamuggantvā dvattiṃsa mahā purisalakkhaṇa asiti anubyañjanā byāmappabhā	ākāsam uggantvā asiti anubyañjanā byāma ppabhā 	dhātuyo ākāsam uggantvā dvattiṃsa mahā purisalakkhaṇa asiti anubyañjanā byāma ppabhā
pūjetvā tambapaṇṇidipe rajjaṃ sattāhaṃ datvā tiṃsa satasahassagghanakaṃ alaṅkāra	pūjetvā tamba paṇṇi dipe rajjam sattāham da tvā alaṅkāra 	pūjetvā tamba paṇṇi dipe rajjam sattāham da tvā tiṃsa sata sahassa agghanakaṃ alaṅkāra
Yo vā sāsapa bījamattampi taṃ dhātuṃ naro pūjaye;	yaḥ vā tam dhātum naraḥ pūjaye 	yo vā sāsapa bījamattampi taṃ dhātuṃ naro pūjaye
Tesaṃ puññaphalaṃ samānamīti taṃ cittappasāde same,	tesam puñña phalam tam citta ppasāde same 	tesam puñña phalam samānam iti tam citta ppasāde same
ādiya gantvā dhātuyo vaṇdatūti iṇdaguttattheropi sakala tambapaṇṇi dīpe manussā dhātuyo	gantvā dhātuyaḥ vaṇdatu iti manussāḥ dhātuyaḥ 	ādiya gantvā dhātuyaḥ vaṇdatu iti iṇdaguttattheropi sakala tambapaṇṇi dīpe manussāḥ dhātuyaḥ
āhaṭa medavaṇṇa pāsāṇena dhātu gabbhaṃ pidahathāti āha. Te sādhūti sampaṭicchitvā	pāsāṇena dhātu gabbham pidahatha ati āha te sādhu iti sampaṭicchitvā 	āhaṭa medavaṇṇa pāsāṇena dhātu gabbham pidahatha iti āha te sādhu iti sampaṭicchitvā
dhātuṃ āharitvā nidhānaṃ karontūti. Mahājano attano attano balānurūpena suvaṇṇa rajatādi	dhātum āharitvā nidhānam karontu iti mahā janaḥ attanaḥ attanaḥ bala anurūpena rajata ādi 	dhātum āharitvā nidhānam karontu iti mahā jano attano attano bala anurūpena suvaṇṇa rajata ādi
mayhaṃ parājayaṃ disvā maññe nāgacchatīti. Tadā thero kariṇda nadī sīse pajjalita	mayham parājayam disvā maññe na āgacchati iti tadā thero 	mayham parājayam disvā maññe na āgacchati iti tadā thero kariṇda nadī sīse pajjalita
pabbate vasanto rañño parivitakkaṃ ñatvā pañcasata khīṇāsava parivusetā ākāsenāgantvā	pabbate vasantaḥ rañño parivitakkam ñatvā ākāsena āgantvā 	pabbate vasantaḥ rañño parivitakkam ñatvā pañcasata khīṇāsava parivusetā ākāsena āgantvā
Rājā theraṃ disvā attano purato nisīdāpetvā evamāha bhante tumhehi saddhiṃ dasamahā	rājā theram disvā evam āha bhante tumhehi saddhim 	rājā theram disvā attano purato nisīdāpetvā evam āha bhante tumhehi saddhim dasamahā
Kilesa sattuṃ ajinitvā ajeyyo maccūsattuko;	sattum a jinitvā ajeyyaḥ maccūsattukaḥ 	Kilesa sattuṃ ajinitvā ajeyyo maccūsattuko
Iti vatvā evaṃ anusāsi. Mahārāja sabboyeva loka sannivāse jātiyā anugato, jarāya anusaṭo, vyādhinā abhibhūto, maraṇena abbhāhato. Tetāha-	iti vatvā evam mahā rāja sabboyā iva loka sannivāse jātiyā anugataḥ jarāya vyādhinā abhibhūtaḥ maraṇena 	iti vatvā evaṃ anusāsi mahārāja sabboyeva loka sannivāse jātiyā anugato jarāya anusaṭo vyādhinā abhibhūto maraṇena abbhāhato tetāha
Ye puññavantāni gatā pasiddhiṃ mahaddhanaṃ jotiyameṇḍakādī,	ye puññavantāni gatā pasiddhim mahat dhanam 	ye puññavantāni gatā pasiddhiṃ mahaddhanaṃ jotiya meṇḍaka ādī
Sayambhūñāṇassa balena santiṃ gatā mahārāja sayambhūnopi,	sayambhu ñāṇassa balena santim gatāḥ mahā rāja 	sayambhu ñāṇassa balena santim gatāḥ mahā rāja sayambhūno pi
Koṭisahassaṃ agghanti mahārāja tayā puna;	koṭi sahassam mahā rāja tayā puna 	koṭi sahassam agghanti mahā rāja tayā puna
Cūḷaṅgaṇiya yuddhamhi parajjhitvā palāyatā,	yuddhamhi parajjhitvā palāyatā 	Cūḷaṅgaṇiya yuddhamhi parajjhitvā palāyatā
satta satta dīnāni laṅkā rajjaṃ sāsanassa pañcakkhattuṃ adāsiṃ sappi sannitta suparisuddha	satta satta dīnāni laṅkā rajjam sāsanassa pañcakkhattum adāsim 	satta satta dīnāni laṅkā rajjam sāsanassa pañcakkhattum adāsim sappi sannitta suparisuddha
vejjehi bhesajjañca bhattañca niccaṃ dāpesi. Catucattālīsa ṭhānesu telullopakañca	vejjehi bhesajjañca bhattañca niccam dāpesi ṭhānesu 	vejjehi bhesajjañca bhattañca niccam dāpesi catucattālīsa ṭhānesu telullopakañca
sappiphāṇita sakkharāni caturaṅgula muṭṭhippamāṇaṃ yaṭṭhimadhukaṃ sāṭakadvayañca	sappiphāṇita sakkharāni yaṭṭhimadhukam sāṭaka dvayam ca 	sappiphāṇita sakkharāni caturaṅgula muṭṭhippamāṇaṃ yaṭṭhimadhukaṃ sāṭaka dvayaṃ ca
dinnattā paṭiggāhakānaṃ yāvadatthaṃ katvā dinnattā pītipāmojjaṃjanayitvā balava saddhāya	dinnattā paṭiggāhakānam yāvadattham katvā dinnattā saddhāya 	dinnattā paṭiggāhakānam yāvadattham katvā dinnattā pītipāmojjam janayitvā balava saddhāya
pañcannaṃ bhikkhusatānaṃ datvā paribhuñji pathavi cālanaka dhammaguttatthero kalyāṇīya	pañcannam bhikkhu satānam da tvā paribhuñji 	pañcannam bhikkhu satānam da tvā paribhuñji pathavi cālanaka dhammaguttatthero kalyāṇīya
adāsinti taṃ sutvā keci ayaṃ rājā maraṇabhayabhito vippalapati, maraṇato abhāyanaka	tam sutvā keci ayam rājā maraṇa bhaya bhitas vippalapati maraṇataḥ 	adāsinti tam sutvā keci ayam rājā maraṇa bhaya bhitas vippalapati maraṇatas abhāyanaka
Sodāni niṭṭhaṃ sampatto thūpavaṃso anākulo,	niṭṭham sampattaḥ thūpa vaṃsaḥ an ākulaḥ 	so dāni niṭṭham sampattaḥ thūpa vaṃsaḥ an ākulaḥ
