original	analyzed	corrected
1. Bhaggā nāma jānapadino rājakumārā. Tesaṃ nivāso ekopi janapado ruḷhīvasena “bhaggā”tveva	bhaggāḥ nāma jānapadinaḥ rāja kumārā tesam nivāsaḥ ekaḥ api janapadaḥ ruḷhī vasena 	bhaggāḥ nāma jānapadinaḥ rāja kumārā tesam nivāsaḥ ekaḥ api janapadaḥ ruḷhī vasena bhaggā iti eva
sabbadā asucipaggharaṇabhāvena. So panassa āturabhāvenāti āha – “āturaṃyeva nāmā”ti.	sabbadā asuci paggharaṇa bhāvena so pana assa ātura bhāvena ati āha nāma ati 	sabbadā asuci paggharaṇa bhāvena so pana assa ātura bhāvena iti āha āturamyeva nāma iti
– “punappunaṃ sāsatū”ti. Aparāparaṃ pavattitaṃ hitavacanaṃ. Anotiṇṇe vatthusmiṃ yo	punappunam sāsatu iti apara aparam hita vacanam anotiṇṇe vatthusmim yaḥ 	punappunam sāsatu iti aparāparam pavattitam hita vacanam anotiṇṇe vatthusmim yo
Vippasannānīti pakatimākāraṃ atikkamitvā visesena pasannāni. Tenāha – “suu pasannānī”ti.	vippasannāni iti pakatim ākāram atikkamitvā visesena pasannāni tena āha 	vippasannāni iti pakatim ākāram atikkamitvā visesena pasannāni tena āha suu pasannāni iti
niddoso”ti. Tenevāha “nirupakkilesatāyā”tiādi. Etenevassindriyavippasannatākāraṇampi	niddoso ti tena iva āha nirupakkilesa tāya atiādi 	niddoso ti tena eva āha nirupakkilesa tāya ati ādi etena eva assa indriya vippasanna tā kāraṇam pi
sammukhā paṭiladdhā, tassa attano pemagāravagahitattā “amatābhiseko”ti veditabbo.	sammukhā paṭiladdhā tassa attano amata abhisekaḥ iti veditabbo 	sammukhā paṭiladdhā tassa attano pemagāravagahitattā amatābhiseko iti veditabbo
parimuccantī”tiādi. So eva ca aveccapasādādhigamena daḷhabhatti nāma. Vuttampi cetaṃ	parimuccanti itiādi saḥ eva ca avecca pasāda adhigamena daḷhabhatti nāma 	parimuccanti iti ādi so eva ca avecca pasāda adhigamena daḷhabhatti nāma vuttam pi ca etaṃ
ādiattho. Tena “upagato”tiādinā vibhaṅge āgataṃ saṃvaravibhaṅgaṃ dasseti. Kāyaduccaritādīnanti	ādi atthaḥ tena upagataḥ iti ādinā vibhaṅge āgatam saṃvara vibhaṅgam dasseti 	ādi atthaḥ tena upagataḥ iti ādinā vibhaṅge āgatam saṃvara vibhaṅgam dasseti kāya duccarita ādīnam ti
Ahaṃ mamāti gāhassāti “attā attaniya”nti gahaṇassa. Maggāmaggavavatthānenāti maggāmaggañāṇavisuddhiyā.	aham mama ati gāhassa ati attā gahaṇassa magga amagga vavatthānena ati magga amagga ñāṇa visuddhiyā 	aham mama ati gāhassa ati attā attaniya nti gahaṇassa magga amagga vavatthānena ati magga amagga ñāṇa visuddhiyā
Amagge maggasaññāyāti amagge obhāsādike “maggo”ti uppannasaññāya. Yasmā sammadeva	amagge magga saññāya ati amagge obhāsa ādike uppanna saññāya yasmai sammat eva 	amagge magga saññāya ati amagge obhāsa ādike maggo ti uppanna saññāya yasmai sammat eva
sālayatāti attho. Dhammaṭṭhitiyaṃ paṭiccasamuppāde. Paṭilomabhāvo sassatucchedaggāho,	atthaḥ dhamma ṭṭhitiyam paṭiccasamuppāde paṭiloma bhāvo 	sālayatāti atthaḥ dhamma ṭṭhitiyam paṭiccasamuppāde paṭiloma bhāvo sassatucchedaggāho
na muñcati, so kileso, yo “saṃyogābhiniveso”tipi vuccati, saṅkhāranimittaggāhassa,	na muñcati so kilesaḥ yo vuccati saṅkhāra nimitta ggāhassa 	na muñcati so kileso yo saṃyogābhiniveso ti pi vuccati saṅkhāra nimitta ggāhassa
ariyo. Paccattavacanañhetaṃ. Eseseti eso eso, atthato anaññoti attho. Tajjāteti atthato	ariyaḥ paccatta vacanam ha etam esa ise iti esaḥ esaḥ atthataḥ anaññaḥ ti attho tad jātā iti atthataḥ 	ariyaḥ paccatta vacanam ha etam esa ise iti esaḥ esaḥ atthataḥ anaññaḥ ti attho taj jātā iti atthataḥ
Kāyoti rūpakāyo. So āturoyeva asavasabhāvato. Rāgadosamohānugatanti appahīnarāgadosamohasantāne	rūpa kāyo so asava sabhāvataḥ rāga dosa moha anugatanti appahīna rāga dosa moha santāne 	kāyo ti rūpa kāyo so āturo yeva asava sabhāvato rāga dosa moha anugatanti appahīna rāga dosa moha santāne
Pacchābhūmiyaṃ aparadisāyaṃ niviṭṭhajanapado pacchābhūmaṃ, taṃ gantukāmā pacchābhūmagamikā.	apara disā ayam niviṭṭha janapadaḥ pacchābhūmam tam gantu kāmā pacchābhūma gamikā 	Pacchābhūmiyaṃ apara disāyaṃ niviṭṭha janapado pacchābhūmaṃ taṃ gantu kāmā pacchābhūma gamikā
Vadanti etenāti vādo, dosoti āha – “tuyhaṃ doso”tiādi. Idheva imasmiṃyeva samāgame.	vadanti etena ati vādaḥ doso ti āha idhā iva imasmin yā iva samāgame 	vadanti etena iti vādo doso ti āha tuyhaṃ doso ti ādi idhā eva imasmin yeva samāgame
iṭṭha”nti vacībhede asatipi tathā lobhuppāde sati abhivadatiyeva nāma. Tenāha “vācaṃ	vacībhede asati pi tathā lobha uppāde sati nāma tena āha vācam 	iṭṭha nti vacībhede asati pi tathā lobha uppāde sati abhivadati yeva nāma tena āha vācam
tassa. Vuttañhetaṃ “nibbattā ye ca tiṭṭhanti, āragge sāsapūpamā”ti.	tassa vuttam ha etam nibbattāḥ ye ca tiṭṭhanti āragge 	tassa vuttam ha etam nibbattā ye ca tiṭṭhanti āragge sāsapūpamā ti
10-11. Kālattayadukkhasuttādivaṇṇanā	kāla ttaya dukkha sutta ādi vaṇṇanā 	kāla ttaya dukkha sutta ādi vaṇṇanā
Tattha yasmā etāni ṭhānagamanādīni rūpārūpadhammānaṃ paṅgulajaccandhānaṃ viya aññamaññūpassayavasena	tattha yasmai etāni ṭhāna gamana ādīni rūpa arūpa dhammānam viya aññamaññu upassaya vasena 	tattha yasmā etāni ṭhāna gamana ādīni rūpa arūpa dhammānaṃ paṅgula jaccandhānaṃ viya aññamaññu upassaya vasena
33. Chandarāgappahānenāti tappaṭibaddhassa chandarāgassa pajahanena. Dabbādi pākatikatiṇaṃ	chanda rāga pahānena ati tad paṭibaddhassa chanda rāgassa pajahanena dabba ādi 	chanda rāga pahānena ati tad paṭibaddhassa chanda rāgassa pajahanena dabba ādi pākatika tiṇaṃ
Tena saṅkhaṃ gacchatīti tena rāgādinā taṃsamaṅgīpuggalo saṅkhātabbataṃ “ratto duṭṭho”tiādinā	tena saṅkham gacchati iti tena rāga ādinā tad samaṅgī puggalaḥ rattaḥ duṭṭhaḥ iti ādinā 	tena saṅkham gacchati iti tena rāga ādinā tad samaṅgī puggalo saṅkhātabbatam ratto duṭṭho iti ādinā
sabbesaṃ rūpārūpadhammānaṃ ṭhitiyā na bhavitabbaṃ. Tassevāti tassā eva ṭhitiyā. Tamatthanti	sabbesam rūpa arūpa dhammānam ṭhitiyā na bhavitabbam tassa iva ati tassāḥ eva ṭhitiyā 	sabbesam rūpa arūpa dhammānam ṭhitiyā na bhavitabbam tassa eva ati tassā eva ṭhitiyā tam attham ti
yathā “yadi me byādhayo bhaveyyuṃ, dātabbamidamosadha”nti. Na hi sakkā etissā eva	yathā yadi me byādhayaḥ bhaveyyum na hi sakkā etissaḥ eva 	yathā yadi me byādhayaḥ bhaveyyum dātabbamidamosadhan ti na hi sakkā etissaḥ eva
44. Sabhāvatosanto vijjamāno kāyo rūpādidhammasamūhoti sakkāyoti āha – “sakkāyo dukkha”nti.	vijjamāno kāyaḥ rūpa ādi dhamma samūho ti sa kāyaḥ iti āha sa kāyaḥ dukkhanti 	Sabhāvato santo vijjamāno kāyo rūpa ādi dhamma samūho ti sakkāyo iti āha sakkāyo dukkhanti
saṃvijjati. Pañcannaṃ indriyānanti cakkhādīnaṃ indriyānaṃ.	saṃvijjati cakkha ādīnam indriyānaṃ 	saṃvijjati pañcannaṃ indriyānanti cakkha ādīnam indriyānaṃ
49-50. Visiṭṭhoti padhāno. Uttamoti ukkaṭṭho. Aññaṃ kiṃ bhaveyyāti aññaṃ kiṃ kāraṇaṃ	visiṭṭhaḥ ti padhānaḥ uttamaḥ ti ukkaṭṭhaḥ aññam kim bhaveyya ati aññam kim kāraṇam 	visiṭṭhaḥ ti padhānaḥ uttamaḥ ti ukkaṭṭhaḥ aññam kim bhaveyya ti aññam kim kāraṇam
Vajirabhedadesanaṃ nāma atthato teparivaṭṭadesanā.	vajirabhedadesanam nāma atthato 	vajirabhedadesanam nāma atthato teparivaṭṭadesanā
53. Upetīti upayo. Kathamupeti? Taṇhāmānādivasenāti āha “taṇhāmānadiṭṭhivasenā”ti.	upeti iti upayaḥ katham upeti taṇhā māna ādi vasena ati āha taṇhā māna diṭṭhi vasena ati 	upeti iti upayo katham upeti taṇhā māna ādi vasena iti āha taṇhā māna diṭṭhi vasena iti
54. Bījajātānīti jāta-saddo padapūraṇamattanti āha “bījānī”ti. Vacanti setavacaṃ.	bīja jātāni iti āha bījāni iti vacanti 	bīja jātāni iti jāta saddo pada pūraṇa mattanti āha bījāni iti vacanti seta vacaṃ
suvisuddhasīlūpanissayo kāmadosajigucchanena. Yadi evaṃ kasmā ime dve upanissayā	kāma dosa jigucchanena yadi evam kasmai ime dve upanissayā 	suvisuddha sīla upanissayo kāma dosa jigucchanena yadi evam kasmā ime dve upanissayā
Upaṭṭhāti ekalakkhaṇena. Kūṭagoṇo viya gamanavīthiṃ. Tatthāti allakaṭṭharāsimhi.	eka lakkhaṇena kūṭa goṇaḥ viya gamana vīthim tattha ati alla kaṭṭha rāsimhi 	upaṭṭhāti eka lakkhaṇena kūṭa goṇo viya gamana vīthiṃ tattha ati alla kaṭṭha rāsimhi
Rūpaṃ abbhaññāsinti sakalabhūtupādārūpaṃ kucchitabhāvato tattha ca tucchavipallāsatāya	rūpam sakala bhūtu pāda arūpam tattha ca tuccha vipallāsa tāya 	rūpam abbhaññāsinti sakala bhūtu pāda rūpam kucchita bhāvato tattha ca tuccha vipallāsa tāya
vuttattā tadeva jeṭṭhaṃ padhānaṃ tathā veneyyajjhāsayato.	vutta ttā tat eva jeṭṭham padhānam tathā 	vutta ttā tat eva jeṭṭham padhānam tathā veneyyajjhāsayato
phasso”tiādippakārena niddhāraṇavacanānaṃyeva niruttitā, sirivaḍḍhakadhanavaḍḍhakapakārānameva	phassaḥ ti ādi ppakārena nirutti tā 	phassaḥ ti ādi ppakārena niddhāraṇa vacanānaṃ yeva nirutti tā siri vaḍḍhaka dhana vaḍḍhaka pakārānam eva
vināsaṃ āpajjanti. Tenāha “vipariṇatanti…pe… naṭṭha”nti. Apākaṭībhūtaṃ ajātattā eva.	vināsam āpajjanti tena āha naṭṭhanti apākaṭībhūtam a jāta ttāḥ eva 	vināsam āpajjanti tena āha vipariṇatanti pe naṭṭhanti apākaṭībhūtam ajātattā eva
samādiyamānā micchāvāyāmūpatthambhitā ataṃsabhāvaṃ “taṃsabhāva”nti gaṇhantī micchāsatīti	samādiyamānā a taṃsa bhāvam taṃsa bhāvanti gaṇhantī micchā asatī iti 	samādiyamānā micchāvāyāmūpatthambhitā a taṃsa bhāvaṃ taṃsa bhāvanti gaṇhantī micchā satī iti
Tenāha “atītaṃ panā”tiādi. Khandhānaṃ upari niruḷhā paṇṇatti.	tena āha atītam khandhānam upari niruḍhā paṇṇatti 	tena āha atītam pana iti ādi khandhānam upari niruḍhā paṇṇatti
63. Gaṇhamānoti “etaṃ mamā”tiādinā gaṇhamāno. Pāsenāti rāgapāsena. Tañhi māro mārapāsoti	gaṇhamānaḥ iti etam mama ati ādinā gaṇhamānaḥ pāsena ati rāga pāsena tat hi māraḥ māra pāsaḥ iti 	gaṇhamānaḥ iti etam mama ati ādinā gaṇhamānaḥ pāsena ati rāga pāsena tat hi māraḥ māra pāsaḥ iti
64-68. “Etaṃ mamā”tiādinā. Maññanā abhinandanā ca. Taṇhāchandoti taṇhā eva chando.	etam mama ati ādinā maññanā abhinandanā ca taṇhā chandaḥ iti taṇhā eva chandaḥ 	etam mama ti ādinā maññanā abhinandanā ca taṇhā chandaḥ iti taṇhā eva chandaḥ
73-75. Catusaccameva kathitaṃ assādādīnañceva samudayādīnañca vasena desanāya pavattattā.	catu accam eva kathitam assāda ādīnam ca iva samudaya ādīnam ca vasena desanāya 	catu saccam eva kathitam assāda ādīnam ca eva samudaya ādīnam ca vasena desanāya pavattattā
vuttovāyamattho; dutiye samudayassādo samudayasaccaṃ, ādīnavo dukkhasaccaṃ, atthaṅgamo	dutiye samudaya ssādaḥ samudaya saccam ādīnavaḥ dukkha saccam atthaṅgamo 	vutto vāyam attho dutiye samudaya ssādaḥ samudaya saccam ādīnavaḥ dukkha saccam atthaṅgamo
atisayitasukhaṃ etesamatthīti sukhinoti āha “jhāna…pe… sukhitā”ti. Taṇhā tesaṃ na	etesam atthi iti sukhino ti āha jhāna pe sukhitā ati taṇhā tesam na 	atisayita sukham etesam atthi iti sukhino ti āha jhāna pe sukhitā ti taṇhā tesam na
Na vikampanti “seyyohamasmī”tiādinā.	na vikampanti sā iyyā uham asmi iti ādinā 	na vikampanti seyyohamasmi iti ādinā
Uddhaṃ tiriyaṃ apācīnanti ettha “uddhaṃ vuccatī”tiādinā rūpamukhena attabhāvaṃ gahetvā	ettha uddham vuccati iti ādinā rūpa mukhena atta bhāvam gahetvā 	Uddham tiriyam apācīnan ti ettha uddham vuccati iti ādinā rūpa mukhena atta bhāvam gahetvā
Sīhanādasamodhānanti sīhanādānaṃ saṃkalanaṃ. Loke attano uttaritarassābhāvā anuttarā.	sīha nāda samodhānam ti sīha nādānam saṃkalanam loke anuttarā 	sīha nāda samodhānam ti sīha nādānam saṃkalanam loke attano uttaritarassa abhāvā anuttarā
Samasīhoti samajātiko samabhāgo ca sīho. Samānosmīti desanāmattaṃ, samappabhāvatāyapi	sama sīhaḥ ti sama jātiko sama bhāgaḥ ca sīhaḥ samānaḥ asmi iti desanā mattam 	sama sīhaḥ ti sama jātiko sama bhāgaḥ ca sīhaḥ samānaḥ asmi iti desanā mattam sama pabhāvatāya api
abhisambodhito purimāvatthāpi sīhasadisaṃ katvā dassitā. Bhāvini, bhūtopacāropi hi	purima avatthā api sīha sadisam katvā dassitā bhāvini bhūta upacāraḥ api hi 	purima avatthā api sīha sadisam katvā dassitā abhisambodhito bhāvini bhūta upacāraḥ api hi
dassitanti āha “idaṃ rupa”ntiādi. “Idaṃ rūpa”nti hi iminā bhūtupādāyabhedarūpaṃ sarūpato	dassitanti āha idam idam hi iminā bhūta upādāya bheda rūpam sarūpataḥ 	dassitanti āha idaṃ rūpanti ādi idaṃ rūpanti hi iminā bhūta upādāya bheda rūpaṃ sarūpato
cittutrāso ca na hotīti. Ñāṇasaṃvego bhayatūpaṭṭhānañāṇaṃ. Itaresaṃ pana devānanti	cittu trāsaḥ ca na hoti iti ñāṇa saṃvegaḥ itaresam pana 	cittu trāsaḥ ca na hoti iti ñāṇa saṃvegaḥ bhaya tūpaṭṭhāna ñāṇaṃ itaresam pana devānam iti
Tenāha “sītenapī”tiādi. Pabbatapādeti cakkavāḷapabbatapāde, so pana tattha accuggato	tena āha pabbata pāde iti cakkavāḷa pabbata pāde so pana tattha accuggato 	tena āha sītena pī ti ādi pabbata pāde iti cakkavāḷa pabbata pāde so pana tattha accuggato
taṃ pana paṇṇaphalādi. Yattha loṇaraso adhiko, taṃ loṇikanti āha “loṇayāgū”tiādi.	tam pana paṇṇa phala ādi yattha loṇa rasaḥ adhikaḥ tam loṇikam ti āha 	tam pana paṇṇa phala ādi yattha loṇa raso adhiko tam loṇikam ti āha loṇa yāgū ti ādi
ajātabuddhi, bāladārako. Vohārakusalo gāmavāsī puriso gāmikapuriso. Upabhogaparibhogārahattā	bāla dārakaḥ vohāra kusalaḥ gāma vāsī purisaḥ gāmika purisaḥ upabhoga paribhoga arahattā 	ajāta buddhi bāla dārakaḥ vohāra kusalaḥ gāma vāsī purisaḥ gāmika purisaḥ upabhoga paribhoga arahattā
upabhogaparibhogaṃ. Tambakaṃsamayattā kūṭo. Mahāsārattā cheko. Aḍḍhasārattā karaṭo.	upabhoga paribhogam kūṭaḥ mahā sārattā chekaḥ aḍḍha sārattā karaṭaḥ 	upabhoga paribhogam tambakaṃsamayattā kūṭo mahā sārattā cheko aḍḍha sārattā karaṭo
Nihīnasārattā saṇho. Ettha ca yathā heraññiko kahāpaṇaṃ cittādibhāvato uddhaṃ kūṭādibhāvaṃ	ettha ca yathā heraññikaḥ kahāpaṇam citta ādi bhāvataḥ uddham kūṭa ādi bhāvam 	ettha ca yathā heraññiko kahāpaṇaṃ citta ādi bhāvato uddhaṃ kūṭa ādi bhāvaṃ
apacayagāmipaṭipadāya paripūraṇato. Tenāha “no ācinātī”tiādi. Vaṭṭaṃ vināsetīti vidhamati	apacaya gāmi paṭipadāya tena āha no ācināti itiādi vaṭṭam vināseti iti vidhamati 	apacaya gāmi paṭipadāya paripūraṇato tena āha no ācināti iti ādi vaṭṭam vināseti iti vidhamati
Namassantiyeva mahatā gāravabahumānena. Tenāha “namo te purisājaññā”tiādi. Tattha	mahatā gārava bahu mānena tena āha namaḥ te purisa ajañña ati ādi tattha 	namassanti yeva mahatā gārava bahu mānena tena āha namo te purisa ajañña iti ādi tattha
Tenāha “ekeko ceva dve dve ca hutvā”ti. Puthujjanānaṃ samuditānaṃ nāma kiriyā tādisīpi	tena āha ekekaḥ ca iva dve dve ca hutvā ati puthujjanānam nāma kiriyā 	tena āha ekekaḥ ca eva dve dve ca hutvā iti puthujjanānam samuditānam nāma kiriyā tādisī pi
patitaṃ yaṃ kiñcipi sīdantaranadiyaṃ vilīyantā sīdanteva, tasmā taṃ parivāretvā ṭhitā	patitam yam kiñcipi vilīyantā sīdantā iva tasmai tam parivāretvā ṭhitā 	patitam yam kiñcipi sīdantaranadiyam vilīyantā sīdantā eva tasmā tam parivāretvā ṭhitā
viyā”ti. Āhārahetūti āmisahetu sappitelādinimittaṃ, tesaṃ paṇāmanā.	viyāti āhāra hetu sappi tela ādi nimittam tesam paṇāmanā 	viyāti āhāra hetu āmisa hetu sappi tela ādi nimittam tesam paṇāmanā
Upari tiparivaṭṭadesanāya animittasamādhiyeva dīpito. Tenāha “yāvañcida”nti. Niddosoti	upari ti parivaṭṭa desanāya dīpitaḥ tena āha niddosaḥ iti 	upari ti parivaṭṭa desanāya animittasamādhiyeva dīpito tena āha yāvañcidanti niddoso iti
dassento “taṇhāsampayutta…pe… jāyatī”ti codeti. Itaro upanissayakoṭi idhādhippetāti	dassento taṇhā sampayutta pe jāyati iti codeti itaraḥ idha adhippetā ti 	"dassento ""taṇhā sampayutta pe jāyati"" iti codeti itaro upanissayakoṭi idha adhippetā ti"
sambhavo eva. Diṭṭhiyāpīti dvāsaṭṭhidiṭṭhiyāpi. Tenāha “catūsu hī”tiādi. Vīsati sakkāyadiṭṭhiyo	eva diṭṭhiyā api iti dvāsaṭṭhi diṭṭhiyā api tena āha catūsu hi itiādi vīsati sakkāya diṭṭhiyo 	sambhavo eva diṭṭhiyā api iti dvāsaṭṭhi diṭṭhiyā api tena āha catūsu hi iti ādi vīsati sakkāya diṭṭhiyo
83. Paṭiccāti nissayaṃ katvā. “Esohamasmī”ti diṭṭhiggāho, “seyyohamasmī”ti mānaggāho	paṭicca ati nissayam katvā esā uham asmi iti diṭṭhi ggāho seyyā uham asmi iti māna ggāho 	paṭicca ati nissayam katvā eso aham asmi iti diṭṭhi ggāho seyyo aham asmi iti māna ggāho
84. Madhurakaṃ vuccati kāye vibhāranti āha – “madhurakajāto viyāti sañjātagarubhāvo	madhurakam vuccati kāye āha madhuraka jātaḥ viyāti sañjāta garu bhāvaḥ 	madhurakam vuccati kāye vibhāranti āha madhuraka jātaḥ viyāti sañjāta garu bhāvaḥ
tasmā. Aññatitthiyā…pe… etadavocuṃ. Tenāha “ekadesena sāsanasamayaṃ jānantā”ti.	tasmai etat avocum tena āha eka desena sāsana samayam jānantā iti 	tasmā aññatitthiyā pe etad avocuṃ tena āha eka desena sāsana samayaṃ jānantā iti
88. Passambhitvāti nirodhetvā. No ca svāhanti no ca su ahaṃ. Parihāyi kuppadhammattā.	no ca svāhā ati nirodhetvā no ca su aham parihāyi kuppa dhamma ttā 	Passambhitvā ti nirodhetvā no ca svāhā ati nirodhetvā no ca su aham parihāyi kuppa dhamma ttā
na bhavissatī”ti. Yadaggenāti yena bhāgena. “Dukkhaṃ patthetiyevā”ti vatvā tattha	na bhavissati iti yad aggena ati yena bhāgena dukkham vatvā tattha 	na bhavissati iti yad aggena ati yena bhāgena dukkham pattheti eva iti vatvā tattha
loko”tiādi diṭṭhiviniveṭhanā. “Ete te, kaccāna, ubho ante anupagammā”tiādi buddhabaladīpanā.	loka uti ādi diṭṭhi viniveṭhanā ete te ubho ante buddha bala dīpanā 	loka uti ādi diṭṭhi viniveṭhanā ete te kaccāna ubho ante anupagammā uti ādi buddha bala dīpanā
viruddhaṃ katvā vadati. Lokadhammoti lujjanasabhāvadhammo. Ko pana soti āha “khandhapañcaka”nti.	viruddham katvā vadati loka dhammo ti ko pana saḥ ti āha khandha pañcakam ti 	viruddham katvā vadati loka dhammo ti lujjana sabhāva dhammo ko pana so ti āha khandha pañcakam ti
“mayhaṃ hī”tiādi. Tathā cāha “akkhāto vo mayā maggo”tiādi. “Tayo lokā kathitā”ti	mayham hi itiādi tathā ca āha akkhātaḥ vaḥ mayā maggaḥ itiādi tayaḥ lokā kathitā ati 	mayham hi iti ādi tathā ca āha akkhāto vo mayā maggo iti ādi tayo lokā kathitā iti
āha. Tena rūpampi nissāratāya bhijjatevāti dasseti. Yathā hi aniccatāya asāratāsiddhi,	āha tena rūpam pi nissāra tāya bhijjatā iva ati dasseti yathā hi anicca tāya 	āha tena rūpam pi nissāra tāya bhijjatā eva iti dasseti yathā hi anicca tāya asāra tā siddhi
evaṃ asāratāyapi aniccatāsiddhīti aniccatāya eva niccasāraṃ thirabhāvasāraṃ dhuvasāraṃ	evam anicca tā siddhi iti anicca tāyaḥ eva nicca sāram thira bhāva sāram dhuva sāram 	evaṃ asāratāya api aniccatā siddhi iti aniccatāya eva nicca sāraṃ thira bhāva sāraṃ dhuva sāraṃ
phassasamodhānaṃ. Pubbuḷasadisā muhuttaramaṇīyatāya. Yasmā ghammakāle sūriyātapasantāpābhinibbattarasmijālanipāte	phassa samodhānam pubbuḷasa disā muhutta ramaṇīya tāya yasmai ghamma kāle 	phassa samodhānam pubbuḷasa disā muhutta ramaṇīya tāya yasmā ghamma kāle sūriya ātapa santāpa abhinibbatta rasmi jāla nipāte
Tenāha “saṇhapaññena cevā”tiādi. Kimigaṇādīnanti ādi-saddena anekagijjhādike saṅgaṇhāti.	tena āha saṇha paññena ca iva atiādi ādi saddena aneka gijjha ādike saṅgaṇhāti 	tena āha saṇha paññena ca eva iti ādi kimi gaṇa ādīnanti ādi saddena aneka gijjha ādike saṅgaṇhāti
samaṃ samakālaṃ. Anenāti bhagavatā. Nayidanti ettha ya-kāro padasandhikaro, idanti	samam sama kālam anena ati bhagavatā ettha yakāro pada sandhi karaḥ 	samam sama kālam anena ati bhagavatā nayidanti ettha yakāro pada sandhi karo idanti
nipātapadaṃ. Taṃ pana yena yena sambandhīyati, taṃ tiliṅgova hotīti “ayaṃ maggabrahmacariyavāso”ti	nipāta padam tam pana yena yena tam hoti iti ayam magga brahmacariya vāsā iti 	nipāta padam tam pana yena yena sambandhīyati tam tiliṅgo va hoti iti ayam magga brahmacariya vāso iti
pavattati tato attānaṃ vivecetuṃ asakkuṇeyyattā. Cittasaṃkilesenevāti dasavidhakilesavatthuvasena	pavattati tatas attānam vivecetum citta saṃkilesena iva ati dasavidha kilesa vatthu vasena 	pavattati tato attānaṃ vivecetuṃ asakkuṇeyyattā cittasaṃkilesena eva iti dasavidha kilesa vatthu vasena
tesaṃ sattānaṃ cittavicittabhāvo. Tenāha “yoniupagatā”tiādi. Sadisacittāva sadisacittabhāvā	tesam sattānam tena āha yoni upagata atiādi sadisa cittā ava sadisa citta bhāvā 	tesam sattānam citta vicittabhāvo tena āha yoni upagata ati ādi sadisa cittā ava sadisa citta bhāvā
mūlaṃ kāraṇaṃ etesanti kammanānattamūlakā, tesaṃ. Liṅganānattaṃ itthiliṅgādinānattavasena	mūlam kāraṇam tesam liṅga nānattam itthi liṅga ādi nānatta vasena 	mūlam kāraṇam etesanti kammanānattamūlakā tesam liṅga nānattam itthi liṅga ādi nānatta vasena
Tenāha “usmīkatānī”ti. Bhāvitānīti kukkuṭavāsanāya vāsitāni. Sammāadhisayanāditividhakiriyākaraṇena	tena āha usmīkatāni iti bhāvitāni iti kukkuṭa vāsanāya vāsitāni 	tena āha usmīkatāni iti bhāvitāni iti kukkuṭa vāsanāya vāsitāni sammā adhisayana ādi tividha kiriyā karaṇena
dārūnaṃ heyyādijānanatthaṃ upanetvā. Dārūnaṃ gaṇḍaṃ haratīti palagaṇḍoti etena palena	upanetvā heyya ādi jānana attham upanetvā gaṇḍam harati iti etena palena 	dārūnaṃ heyyā ādi jānana atthaṃ upanetvā dārūnaṃ gaṇḍaṃ harati iti palagaṇḍo ti etena palena
kāmarāgaṃ pariyādiyatī”tiādi. Santānetvāti kasanaṭṭhānaṃ sabbaso vitanetvā pattharitvā.	kāma rāgam santānetvā ati kasana ṭṭhānam sabbasas vitanetvā pattharitvā 	kāma rāgam pariyādiyatī ti ādi santānetvā ti kasana ṭṭhānam sabbaso vitanetvā pattharitvā
pañcasu upamāsu. Purimāhīti kassakapabbajalāyanaambapiṇḍiupamāhi aniccasaññāya kiccaṃ	pañcasu upamāsu purima ahi iti anicca saññāya kiccam 	pañcasu upamāsu purimāhi iti kassaka pabbaja lāyana amba piṇḍi upamāhi anicca saññāya kiccaṃ
113-114. Yāvatāti yasmā. Imāya…pe… samannāgatoti “idaṃ dukkhanti yathābhūtaṃ nappajānātī”tiādinā	yāvatā iti yasmai samannāgataḥ ti idam dukkham ti yathābhūtam na pajānāti itiādinā 	yāvatā iti yasmā imāya pe samannāgataḥ ti idam dukkham ti yathābhūtam na pajānāti itiādinā
117-121. Tīraṃ vuccati vaṭṭaṃ orimatīranti katvā. Tenāha “athāyaṃ itarā pajā, tīramevānudhāvatī”ti.	tīram vuccati vaṭṭam katvā tena āha atha ayam itarā pajā tīram eva anudhāvati iti 	tīram vuccati vaṭṭam orimatīram iti katvā tena āha atha ayam itarā pajā tīram eva anudhāvati iti
136-149. Anto aggi mahanto chārikarāsi, tattha ukkuḷavikulato akkamantaṃ yāva kesaggaṃ	antar aggi mahantaḥ tattha ukkuḷa vikulataḥ akkamantam yāva kesaggam 	antar aggi mahantaḥ chārikarāsi tattha ukkuḷa vikulataḥ akkamantam yāva kesaggam
160. Mārasaddoyaṃ bhāvasādhanoti dassento “māro vā assāti maraṇaṃ vā bhaveyyā”ti	māra saddaḥ iyam bhāva sādhanaḥ ti dassento māraḥ vā assa ati maraṇam vā bhaveyya iti 	māra saddaḥ ayaṃ bhāva sādhanaḥ iti dassento māraḥ vā assa iti maraṇam vā bhaveyya iti
na tato paraṃ. Assāti brahmacariyassa.	na tatas param brahmacariyassa 	na tato param assati brahmacariyassa
161-169. Laggapucchāti lagganassa bajjhanassa pucchā. Yadi rūpādīsu sattattā satto,	lagga pucchā ati lagganassa bajjhanassa pucchā yadi rūpa ādīsu 	lagga pucchā ti lagganassa bajjhanassa pucchā yadi rūpa ādīsu sattattā satto
vāyantīti bādhati. Esa nayo nadiyo sandantītiādīsu. Udakaṃ panāti dutiyaṃ kāyaṃ sandhāyāha.	vāyanti iti bādhati udakam panāti dutiyam kāyam sandhāya āha 	vāyanti iti bādhati esa nayo nadiyo sandanti iti ādīsu udakam panāti dutiyam kāyam sandhāya āha
dinnaṃ pana annādivatthuṃ kathaṃ paṭikkhipanti. Esa nayo “yiṭṭhaṃ huta”nti etthāpi.	dinnam pana anna ādi vatthum katham paṭikkhipanti esa nayaḥ ettha api 	dinnam pana anna ādi vatthum katham paṭikkhipanti esa nayo yiṭṭham hutam ti ettha api
“natthi mātā, natthi pitā”ti vadanti, na mātāpitūnaṃ, nāpi tesu idāni kariyamānasakkārāsakkārānaṃ	natthi mātā natthi pitā iti vadanti na mātā pitūnam na api tesu idāni 	natthi mātā natthi pitā iti vadanti na mātā pitūnam na api tesu idāni kariyamāna sakkāra asakkārānam
gahitaāpo viya vassodakabhāvena punapi mahāsamuddaṃ, sūriyaraṃsito gahitaindaggisaṅkhātatejo	vassa udaka bhāvena puna api mahā samuddam sūriya raṃsitaḥ gahita aindaggi saṅkhāta tejaḥ 	gahita āpo viya vassa udaka bhāvena puna api mahā samuddam sūriya raṃsito gahita indaggi saṅkhāta tejo
viya punapi sūriyaraṃsiṃ, mahāvāyukhandhato niggatamahāvāyo viya tameva vāyukhandhaṃ	sūriya raṃsim mahā vāyu khandhataḥ niggata mahā vāyaḥ viya tam eva vāyu khandham 	viya puna api sūriya raṃsim mahā vāyu khandhataḥ niggata mahā vāyaḥ viya tam eva vāyu khandham
“daṇḍena pīḷentassā”ti. Papañcasūdaniyaṃ “tajjentassa cā”ti attho vutto, idha pana	daṇḍena pīḷentassa ati tajjentassa ca ati atthaḥ vuttaḥ idha pana 	daṇḍena pīḷentassa iti Papañcasūdaniyaṃ tajjentassa ca iti attho vutto idha pana
sumaṅgalavilāsiniyaṃ viya tajjanaṃ paribhāsanaṃ daṇḍeneva saṅgahetvā “daṇḍena pīḷentassa”icceva	tad janam paribhāsanam daṇḍena iva saṅgahetvā daṇḍena 	sumaṅgalavilāsiniyaṃ viya tad janam paribhāsanam daṇḍena eva saṅgahetvā daṇḍena pīḷentassa icceva
Gharassa bhitti anto ca bahi ca sandhitā hutvā ṭhitāva gharasandhi. Kiñcipi asesetvā	gharassa bhitti anto ca bahi ca sandhitā hutvā ghara sandhi 	gharassa bhitti anto ca bahi ca sandhitā hutvā ṭhitāva ghara sandhi kiñcipi asesetvā
niccatāya nibbikārattā, sarīraṃ pana acetanaṃ kaṭṭhakaliṅgarūpamaṃ, tasmiṃ vikopitepi	niccatāya sarīram pana acetanam tasmin vikopite pi 	niccatāya nibbikārattā sarīram pana acetanam kaṭṭhakaliṅgarūpamam tasmin vikopite pi
malīnabhāvassa kāraṇaṃ. Visuddhipaccayanti saṃkilesato visuddhiyā vodānassa kāraṇaṃ.	malīna bhāvassa kāraṇam saṃkilesataḥ visuddhiyāḥ vodānassa kāraṇam 	malīna bhāvassa kāraṇaṃ visuddhipaccayanti saṃkilesato visuddhiyā vodānassa kāraṇaṃ
kiñci natthi. Tenāha “yamhī”tiādi. Nidassanamattañcetaṃ, saṃkilesikampi cāyaṃ paṭikkhipateva.	kiñci natthi tena āha yamhi itiādi saṃkilesikam pi ca ayam paṭikkhipatā iva 	kiñci natthi tena āha yamhi itiādi nidassanamattañcetaṃ saṃkilesikam pi ca ayaṃ paṭikkhipati eva
pāṇā, te pana so ekindriyādivasena vibhajitvā vadatīti āha “ekindriyo”tiādi. Aṇḍakosādīsu	te pana saḥ ekindriya ādi vasena vibhajitvā vadati iti āha aṇḍa kosa ādīsu 	pāṇā te pana so ekindriya ādi vasena vibhajitvā vadati iti āha ekindriyo ti ādi aṇḍa kosa ādīsu
sabhāvo eva akittimo eva. Tenāha “yena hī”tiādi. Chaḷabhijātiyo parato vitthārīyanti.	sabhāvaḥ eva akittimaḥ eva tena āha yena hi itiādi paratas 	sabhāvaḥ eva akittimaḥ eva tena āha yena hi itiādi chaḷabhijātiyo paratas vitthārīyanti
āha “kūṭaṭṭhā”ti. Yamidaṃ “bījādito aṅkurādi jāyatī”ti vuccati, tañca vijjamānameva	āha yam idam bīja āditaḥ aṅkura ādi jāyati iti vuccati tat ca vijjamānam eva 	āha kūṭaṭṭhā iti yam idam bīja āditaḥ aṅkura ādi jāyati iti vuccati tat ca vijjamānam eva
cāti neva koci hantā ghātetā vā. Tenāha “sattannantvevā”tiādi. Yadi koci hantā natthi,	ca ati na iva koci hantā ghātetā vā tena āha yadi koci hantā natthi 	ca ati na iva koci hantā ghātetā vā tena āha sattannantvevā ti ādi yadi koci hantā natthi
Pamukhayonīnanti manussatiracchānādīsu khattiyabrāhmaṇādisīhabyagghādivasena padhānayonīnaṃ.	manussa tiracchāna ādīsu khattiya brāhmaṇa ādi sīha byaggha ādi vasena padhāna yonīnam 	Pamukha yonīnanti manussa tiracchāna ādīsu khattiya brāhmaṇa ādi sīha byaggha ādi vasena padhāna yonīnam
Pavuṭāti sabbagaṇṭhikā. Paṇḍitopi…pe… uddhaṃ na gacchati. Kasmā? Sattānaṃ saṃsaraṇakālassa niyatabhāvato.	sabbagaṇṭhikā uddham na gacchati kasmā sattānam saṃsaraṇa kālassa niyata bhāvataḥ 	Pavuṭā ti sabbagaṇṭhikā paṇḍito pi pe uddhaṃ na gacchati kasmā sattānaṃ saṃsaraṇa kālassa niyata bhāvato
pavattaṃ adhimokkhaṃ. Dassanampi sammattaṃ, taṃsijjhānavasena pavattaniyāmo sammattaniyāmo,	pavattam adhimokkham dassanam pi sammattam pavatta niyāmo sammatta niyāmo 	pavattam adhimokkham dassanam pi sammattam tam sijjhāna vasena pavatta niyāmo sammatta niyāmo
332-340. Na evaṃ hotīti ettha “ahaṃ samāpajjāmī”ti vā, “ahaṃ samāpanno”ti vā mā hotu	na evam hoti iti ettha aham samāpajjāmi iti vā aham samāpannaḥ ti vā mā hotu 	na evam hoti iti ettha aham samāpajjāmi iti vā aham samāpanno iti vā mā hotu
vuttaṃ. Tena vuttaṃ “yaṃ kiñci gamanapaccaya”nti. Patthanaṃ katvā…pe… tattha nibbattanti	vuttam tena vuttam yam kiñci patthanam katvā āpe tattha nibbattanti 	vuttam tena vuttam yam kiñci gamanapaccayanti patthanam katvā āpe tattha nibbattanti
Tattha kambalassatarā dhataraṭṭhāti ime jātivasena vuttā. Sattasīdantaravāsinoti	tattha kambalassatarā dhataraṭṭhā ti ime jāti vasena vuttā 	tattha kambalassatarā dhataraṭṭhā ti ime jāti vasena vuttā sattasīdantaravāsino ti
438-549. Mūlagandhādibhedaṃ gandhaṃ avanti apayuñjantīti gandhabbā, tesaṃ kāyo samūho	mūla gandha ādi bhedam gandham avanti apayuñjanti iti gandhabbā tesam kāyaḥ samūhaḥ 	mūla gandha ādi bhedam gandham avanti apayuñjanti iti gandhabbā tesam kāyo samūho
“so hī”tiādimāha. Upakappatīti nivāsaṭṭhānabhāvena viniyuñjati. Gandhagandheti gandhānaṃ	saḥ hi itiādim āha upakappati iti nivāsa ṭṭhāna bhāvena viniyuñjati gandha gandha iti 	saḥ hi itiādim āha upakappati iti nivāsa ṭṭhāna bhāvena viniyuñjati gandha gandha iti gandhānaṃ
patthanā. Yathādhippetaphalāni sarikkhadānattāva adhippetaphalaṃ dentu, asarikkhadānaṃ	patthanā yathā adhippeta phalāni adhippeta phalam dentu a sarikkha dānam 	patthanā yathā adhippeta phalāni sarikkha dānattā va adhippeta phalam dentu a sarikkha dānam
kathanti? Tampi detiyeva puññassa sabbakāmadadattāti āha “asarikkhadānampī”tiādi.	katham ti tam pi detiyā iva puññassa āha a sarikkha dānam pi itiādi 	katham ti tam pi detiyā iva puññassa sabba kāma dada ttā ti āha a sarikkha dānam pi iti ādi
Tesaṃ samūho valāhakadevakāyoti āha “valāhakakāyikā”tiādi. Sītakaraṇavalāhakāti sītaharaṇavalāhakā.	tesam samūhaḥ āha valāhaka kāyikā atiādi sīta karaṇa valāhakā ati sīta haraṇa valāhakā 	tesam samūhaḥ valāhaka devakāyo ti āha valāhaka kāyikā ti atiādi sīta karaṇa valāhakā ti sīta haraṇa valāhakā
662. Samādhikusaloti samādhismiṃ kusalo. Tayidaṃ samādhikosallattaṃ saha jhānaṅgayogena	samādhi kusalaḥ iti samādhismin kusalaḥ saha jhāna aṅga yogena 	samādhi kusalo iti samādhismin kusalo tayidaṃ samādhi kosallaṃ saha jhāna aṅga yogena
pana kusaloti atthoti āha – “jhānaṃ ṭhapetuṃ akusalo”ti. Sattaṭṭhaaccharāmattanti	pana kusalaḥ ti attho ti āha jhānam ṭhapetum akusalaḥ ti 	pana kusalaḥ ti attho ti āha jhānam ṭhapetum akusalaḥ ti sattaṭṭhaaccharāmattan ti
sattaṭṭhaaccharāmattaṃ khaṇaṃ jhānaṃ ṭhapetuṃ na sakkoti adhiṭṭhānavasībhāvassa anipphāditattā.	khaṇam jhānam ṭhapetum na sakkoti adhiṭṭhāna vasībhāvassa a nipphādita ttā 	sattaṭṭha accharā mattaṃ khaṇam jhānam ṭhapetum na sakkoti adhiṭṭhāna vasībhāvassa a nipphādita ttā
